JOKER	日奈森纺	父亲
爱新觉罗·奕詝	爱新觉罗·旻宁	父亲
洪启熙	洪有秩	父亲
查查	查台传	父亲
范一夫	范曾	父亲
两仪未那	黑桐干也	父亲
桥本龙太郎	桥本龙五	父亲
蔡辰洲	蔡万春	父亲
贯镇山	贯盛习	父亲
小白玉梅	白玉梅	父亲
周金福	周治安	父亲
杨元元	杨荫东	父亲
曹植	曹操	父亲
阿朱	段正淳	父亲
李名强	李祖彝	父亲
白道彬	白允植	父亲
房仕胜	房道龙	父亲
路易斯·雷诺	阿尔弗雷德	父亲
袁保恒	袁甲三	父亲
慈圣光献皇后	曹玘	父亲
孝端文皇后	莽古斯	父亲
王小理	王爱军	父亲
朱俊	朱庆林	父亲
邱士楷	邱弘茂	父亲
汪延	汪华	父亲
达科塔-约翰逊	Don	父亲
张云溪	张德俊	父亲
元怀	孝文帝元宏	父亲
林志宏	林文建	父亲
李凤翔	李顺来	父亲
莫言	莫贻凡	父亲
威理博·斯涅尔	鲁道夫·斯涅尔	父亲
李时炯	李明博	父亲
李大新	李舆卓	父亲
敦敏	瑚趴	父亲
宋景公	宋元公	父亲
洪敬尧	洪一峰	父亲
薄熙来	薄一波	父亲
懿献梁皇后	梁商	父亲
冯雪艳	冯官鸿	父亲
纳兰性德	纳兰明珠	父亲
刘彻	汉景帝	父亲
谷望宁	谷景生	父亲
张巍	张文涛	父亲
文千岁	黄宝任	父亲
肖恩·墨菲	托尼·墨菲	父亲
基拉·科尔皮	劳诺·科尔皮	父亲
杨白子	杨秋人	父亲
阮明园	阮海林	父亲
吕大防	吕蕡简	父亲
福利斯特·马尔斯	老福利斯特	父亲
白凤鸣	白晓山	父亲
万超尘	万昊	父亲
陈扬钊	陈明仁	父亲
朱常洵	明神宗	父亲
阿里埃勒-沙龙	沙廖尔	父亲
陈江和	陈金荣	父亲
关幼波	关月波	父亲
和硕和惠公主	爱新觉罗-胤祥	父亲
宋仲虎	宋子安	父亲
梁漱溟	梁巨川	父亲
武德公主	汉章帝	父亲
陈砾	陈布雷	父亲
拉吉夫·甘地	英迪拉·甘地	父亲
荀逝敖	荀息	父亲
广兴	高晋	父亲
本堂瑛佑	伊桑-本堂	父亲
蒋进兴	郭英男	父亲
唐高祖李渊第十七女	唐高祖李渊	父亲
冯刚	冯志	父亲
张爱玲	张廷	父亲
陈露	陈喜勤	父亲
李振辉	李海泉	父亲
寿阳公主	明穆宗朱载垕	父亲
钱永健	钱学榘	父亲
朱载堉	朱厚烷	父亲
郑子亹	郑庄公	父亲
章金莱	章宗义	父亲
梁左	范荣康	父亲
昆廷-塔伦蒂诺	托尼??塔伦蒂诺	父亲
尼格尔·德容	杰瑞·德容	父亲
万瀛女	万季飞	父亲
奚斤	奚箪	父亲
王翚	王豢龙	父亲
李赣驹	李烈钧	父亲
二叶百合子	东若武藏	父亲
包玉刚	包陪庆	父亲
肖若兰	肖筮易	父亲
丁春诚	丁三光	父亲
曹圉	昌若	父亲
陈涛	陈岳顺	父亲
安东尼·亨利·贝克勒尔	亚历山大·爱德蒙·贝克勒尔	父亲
波塞冬	克洛诺斯	父亲
杨荫榆	杨老圃	父亲
张元和	张冀牖	父亲
洪虎	洪学智	父亲
华筝	成吉思汗	父亲
曹斯杰	曹忆非	父亲
内藤昌丰	工藤虎丰	父亲
刘田一	刘觉民	父亲
李守礼	李贤	父亲
赵安宗	赵裔	父亲
施剑翘	施从云	父亲
卡布斯-本-赛义德	赛义德-本-泰姆尔	父亲
顾高地	顾圣婴	父亲
朱高煦	朱棣	父亲
陈丹淮	陈毅	父亲
杰瑞米·雷纳	Lee	父亲
梅根·罗西	维恩·罗西	父亲
李西山	李崇汉	父亲
慈少泉	慈瑞泉	父亲
贾迎春	贾赦	父亲
丰臣秀次	三好吉房	父亲
涩川春海	安井算哲	父亲
皮埃尔-萨科齐	萨科奇	父亲
小小志	林志颖	父亲
马步芳	马麒	父亲
珍妮-巴斯	杰里-巴斯	父亲
易思玲	易才军	父亲
关少曾	关学曾	父亲
隋炀帝杨广长女	隋炀帝杨广	父亲
何塞普·瓜迪奥拉	Dolors	父亲
王离	王贲	父亲
齐格蒙特三世	John III	父亲
徐情情	徐xx	父亲
陈大念	陈正山	父亲
红色谍王	阿道夫·佐尔格	父亲
蔡和森	蔡蓉峰	父亲
皮埃尔·卡西拉奇	斯蒂法诺·卡西拉奇	父亲
来佳俊	来戈鸿	父亲
黄月英	黄承彦	父亲
汤古代	努尔哈赤	父亲
李恩聚	李振基	父亲
吴连枝	吴秀峰	父亲
丁立干	丁传靖	父亲
钱永佑	钱学榘	父亲
郑子婴	郑庄公	父亲
唐翼明	唐振楚	父亲
房遗爱	房玄龄	父亲
亚历克斯-张伯伦	马克-张伯伦	父亲
直江兼续	樋口兼丰	父亲
拓跋绰	拓跋力微	父亲
骆养性	骆思恭	父亲
孙二娘	孙元	父亲
左文静	左晓峰	父亲
宗馥莉	宗庆后	父亲
霍震霆	霍英东	父亲
唐贝欣	唐基华	父亲
孙峰	孙玉才	父亲
李庆华	李焕	父亲
俞秀莲	俞雄远	父亲
菲利普王子	卡尔十六世·古斯塔夫	父亲
章诒和	章伯钧	父亲
元献皇后	杨知庆	父亲
齐妃	李文烨	父亲
文根英	文洪根	父亲
霍华德-巴菲特	沃伦-巴菲特	父亲
米海尔-亚历山德罗夫	普拉曼-亚历山德罗夫	父亲
刘伯明	刘志文	父亲
华严	严琥	父亲
鸠山一郎	鸠山和夫	父亲
刘晓榕	刘培善	父亲
虞喜	虞察	父亲
李忆兰	付崇阳	父亲
王淑嫒	王隆夫	父亲
慈禧太后	惠征	父亲
王琎	王士骏	父亲
斯蒂芬妮·基	约翰·基	父亲
安童	霸突鲁	父亲
陈眕	陈凖	父亲
孟古哲哲	杨吉砮	父亲
刘天华	刘宝珊	父亲
郭元汾	郭春山	父亲
赵成侯	赵敬侯	父亲
铁保	诚泰	父亲
张世安	张汤	父亲
马克斯-德尔布吕克	汉斯-德尔布吕克	父亲
全宝蓝	全英路	父亲
张国彦	张绣	父亲
玛利-弗朗索瓦-萨迪-卡诺	伊波利特-卡诺	父亲
毕朔望	毕振达	父亲
关云娣	关中	父亲
华天	华山	父亲
李砚萍	李顺来	父亲
东光公主	韦捷	父亲
奥利维亚·芒恩	萨姆·玛恩	父亲
姚明	姚志源	父亲
郭庆华	郭余一	父亲
小渊优子	小渊惠三	父亲
金俗	金王孙	父亲
李侍尧	李元亮	父亲
鄂克逊	鄂通武	父亲
裴永利	裴世长	父亲
石头	郭涛	父亲
卜祥志	卜繁铎	父亲
刘恭	刘盈	父亲
朝鲜世祖	李裪	父亲
蒋蓉	蒋鸿泉	父亲
文献皇后	独孤信	父亲
蒋雯丽	蒋培基	父亲
陈柏林	陈祖勇	父亲
陈红	陈永才	父亲
王淑明	王隆夫	父亲
福田赳夫	福田善治	父亲
李和平	李德生	父亲
骆宾王	骆履元	父亲
罗纳德-威尔逊-里根	约翰-杰克-里根	父亲
埃罗·沙里宁	G·E·沙里宁	父亲
朱有煴	朱橚	父亲
熊毅	熊继成	父亲
科琳-鲁尼	托尼-麦克罗林	父亲
奥斯卡-王尔德	William	父亲
徐玉华	徐洪春	父亲
孝文帝元宏妻子孝文废皇后冯氏	冯熙	父亲
黄俊钦	黄昌义	父亲
朱莲桂	朱三喜	父亲
嵇璜	嵇曾筠	父亲
陆谷孙	陆达成	父亲
约翰·赫歇尔	威廉·赫歇尔	父亲
罗家伦	罗传珍	父亲
黄彦鸿	黄玉柱	父亲
王之卓	王绍曾	父亲
手冢国光	手冢国晴	父亲
陈水扁	陈松根	父亲
万贵妃	万贵	父亲
福康安	富察·傅恒	父亲
胡益华	胡敦本	父亲
冯涛	冯之浚	父亲
路易丝·布朗	约翰·布朗	父亲
王茜	王宝泉	父亲
山姆·休斯顿	塞缪尔·休斯顿	父亲
熊伯齐	熊克武	父亲
包惠僧	包存嘉	父亲
卫国文懿公主	唐懿宗	父亲
汪伯奇	汪汉溪	父亲
胡俨	胡鼎	父亲
李秋凤	李海泉	父亲
萨马兰奇·萨利萨奇斯	萨马兰奇	父亲
陶大伟	陶一珊	父亲
费俊龙	费长宝	父亲
孙佐臣	孙八	父亲
骆家辉	骆荣硕	父亲
邓散木	邓慕儒	父亲
唐玄宗	唐睿宗	父亲
王瑜	王振虎	父亲
张彭春	张云藻	父亲
林书豪	林继明	父亲
李光	李宗义	父亲
徐冠仁	徐由白	父亲
叶盛章	叶春善	父亲
周启生	周吉	父亲
李清念	李天德	父亲
张琮	张其锽	父亲
沈昌文	沈汉英	父亲
拉尔夫·约翰逊·本奇	弗雷德·本奇	父亲
陈天华	陈善	父亲
爱新觉罗-载湉	爱新觉罗-奕譞	父亲
冯其庸	冯祖懋	父亲
钱思进	钱三强	父亲
朱德群	朱禹成	父亲
赛罗-奥特曼	赛文-奥特曼	父亲
杰西奈	查尔斯	父亲
姬泄心	周简王姬夷	父亲
赖文峰	赖水强	父亲
荣智健	荣毅仁	父亲
吴舜文	吴镜渊	父亲
邓文迪	邓德辉	父亲
梁适	梁灏	父亲
朝鲜中宗	朝鲜成宗	父亲
诗琳通公主	普密蓬-阿杜德	父亲
陈宰均	陈伯庸	父亲
弗拉迪米尔·魏斯	老弗拉迪米尔·魏斯	父亲
龚如心	龚云龙	父亲
周萌萌	周瑞新	父亲
王向党	王玉芬	父亲
李克农	李哲卿	父亲
刘毓嵩	刘文淇	父亲
乔治一世	欧尼斯特·奥古斯都	父亲
谢玄	谢石	父亲
龚书恒	龚明	父亲
杨不悔	杨逍	父亲
稻叶正成	林政秀	父亲
王朔	王志才	父亲
王雱	王安石	父亲
科菲-安南	亨利-雷金纳德-安南	父亲
杨影枫	杨熙烈	父亲
赵烈侯	赵献侯	父亲
张静江	张宝善	父亲
林挺生	林尚志	父亲
伊达政宗	伊达辉宗	父亲
法拉墨	迪耐瑟二世	父亲
安娜-查普曼	瓦西里	父亲
陈祖涛	陈昌浩	父亲
郑小龙	古龙	父亲
推古天皇	钦明天皇	父亲
西恩-赫本-费勒	梅尔-费勒Mel	父亲
贵由汗	元太宗	父亲
席琳·迪翁	Adhemar	父亲
刘楚玉	刘骏	父亲
裘少戎	裘盛戎	父亲
鸠山邦夫	鸠山威一郎	父亲
晋安帝	司马曜	父亲
钱忱	钱景臻	父亲
陈杞柏	陈簪聚	父亲
张柏芝	张仁勇	父亲
唐中宗李显和韦皇后之女李仙蕙	唐中宗李显	父亲
陆雁华	陆耀良	父亲
陈永棋	陈瑞槐	父亲
宗璞	冯友兰	父亲
路易斯·雪佛兰	约瑟夫	父亲
冯品湘	冯圣夫	父亲
本杰明·哈里森	约翰·斯科特·哈里森	父亲
契诃夫	帕维尔-叶果罗维奇-契诃夫	父亲
胡德棒	胡长山	父亲
莫翰文	莫增禄	父亲
亨利·都铎	爱德华·都铎	父亲
王申培	王永熙	父亲
蒋小涵	蒋涵	父亲
冯理达	冯玉祥	父亲
梅西	豪尔赫	父亲
杨振铭	杨澄甫	父亲
郝龙斌	郝柏村	父亲
哈维·阿隆索	佩里克·阿隆索	父亲
张安世	张汤	父亲
刘思齐	刘谦初	父亲
潘天寿	潘秉璋	父亲
魏际瑞	魏兆凤	父亲
沢田纲吉	沢田家光	父亲
胡军	胡宝善	父亲
张温	张允	父亲
曹霖	曹丕	父亲
任家萱	任明廷	父亲
陈晓亮	陈先水	父亲
殷震贤	汤致祥	父亲
安东尼奥-维瓦尔第	乔瓦尼-巴蒂斯塔-维瓦尔第	父亲
卢西娅·普恩佐	路易斯·普恩佐	父亲
谢飞	谢觉哉	父亲
尹喜地	尹明善	父亲
孙琪	孙博宇	父亲
李紫阳	李先念	父亲
克莱尔·达内斯	克里斯托弗达内斯	父亲
白玉堂	毕善福	父亲
朱恬燆	朱胤杲	父亲
李根	李永波	父亲
马雪君	马晓立	父亲
梁思睿	梁启勋	父亲
马伯声	马仁德	父亲
郑襄公	郑穆公	父亲
阮玲玉	阮用荣	父亲
李庆春	李永利	父亲
宋健生	宋世雄	父亲
赵曙	赵祯	父亲
村上义清	村上显国	父亲
肖国栋	肖为兴	父亲
娜塔莎	路德韦格-科赫称	父亲
姚武斌	姚浩君	父亲
永安公主	明成祖朱棣	父亲
马仲英	马宝	父亲
罗聘	罗愚溪	父亲
火亮	火志刚	父亲
罗鹰石	罗功贤	父亲
乌塞恩-博尔特	Wellesly Bolt	父亲
拿破仑	卡洛-波拿巴	父亲
程云	程斌	父亲
河亶甲	商王太戊	父亲
宋青书	宋远桥	父亲
丁建中	丁正洪	父亲
鲁道夫·朱利安尼	哈勒德·安卓·朱利安尼	父亲
伍端	伍瘦梅	父亲
德仁	明仁	父亲
成池铉	成汉国	父亲
陈一冰	陈云峰	父亲
贾惜春	贾敬	父亲
迪甘	鲍斯高-伊泽森-柏莱拉-莱特	父亲
吴育贤	吴俊亿	父亲
杨飞	杨一新	父亲
孙坚	孙策	父亲
东汉末年名将关羽之女	关羽	父亲
萧绰	萧思温	父亲
王江穗	王宁	父亲
梁光烈	梁兴初	父亲
平清盛	平忠盛	父亲
张橹	张国勇	父亲
梁方仲	梁广照	父亲
董立均	董建华	父亲
问天	苍龙	父亲
贝蒂·戴维斯	哈洛·莫雷尔·戴维斯	父亲
谢东	谢凌霄	父亲
饶宗颐	饶锷	父亲
罗纳德-里根	约翰-杰克-里根	父亲
长城公主	梁武帝萧衍	父亲
朱仲禄	朱端	父亲
王文林	王长友	父亲
邹韬奋	邹国珍	父亲
李元芳	李嵋	父亲
曹干	曹操	父亲
黄思佳	黄安	父亲
蒯祥	蒯富	父亲
马克·麦道夫	伯纳德·麦道夫	父亲
晏紫	晏长明	父亲
瑞国公主	宋理宗赵昀	父亲
章汉夫	谢仁冰	父亲
白玉田	白建桥	父亲
李维德	李安华	父亲
金晶	金建生	父亲
金世根	金和忠	父亲
秦二世	秦始皇	父亲
赵美心	赵华进	父亲
完颜劾里钵	完颜乌古	父亲
包陪丽	包玉刚	父亲
科琳·鲁尼	托尼-麦克罗林	父亲
卫王	度宗赵禥	父亲
泰夏安·普林斯	托马斯	父亲
朱闰生	朱自清	父亲
孙立新	孙同鑫	父亲
陶行知	陶位朝	父亲
马贤达	马凤图	父亲
明太祖朱元璋	朱世珍	父亲
李赣骝	李烈钧	父亲
诺尔曼	布仁巴雅尔	父亲
陈康堤	陈奕迅	父亲
吴景滔	吴忠义	父亲
赵伟	赵庭富	父亲
那彦图	达尔玛	父亲
戴复东	戴安澜	父亲
吴敬恒	吴有成	父亲
彼得-伊万诺维奇-卡法罗夫	伊万-格利戈利耶维奇	父亲
沈比利	沈约翰	父亲
包丹庭	包荣星	父亲
沃尔特·布朗	乔治·V·布朗	父亲
费玉清	张舞曦	父亲
吴安然	吴敬仪	父亲
郑声公	郑定公	父亲
陈静	陈跃亮	父亲
太康公主	明孝宗朱祐樘	父亲
滕海滨	滕景福	父亲
郭瑞祥	郭长生	父亲
黄雪辰	黄逸	父亲
张猛	张云田	父亲
稻垣阳	稲垣弘一九段	父亲
陈南翔	陈文远	父亲
朱启钤	朱庆墉	父亲
姚振宗	姚仰云	父亲
爱新觉罗-胤祥	康熙帝	父亲
冯钟越	冯友兰	父亲
谢冰心	谢葆璋	父亲
黄光宜	黄汉伟	父亲
西耶娜·米勒	爱德华·米勒	父亲
吴君祥	夏春秋	父亲
王光和	王治昌	父亲
孙天义	孙殿英	父亲
詹妮弗·康纳利	杰勒德·康奈利	父亲
契	帝喾	父亲
周晓平	周有光	父亲
刘源	刘少奇	父亲
刘娥	刘通	父亲
马里恩-克利夫兰-德尔-阿门	格罗弗-克利夫兰	父亲
杰奎琳-马尔斯	老弗雷斯特	父亲
李万春	李新兰	父亲
李建成	李渊	父亲
李冠丰	李双江	父亲
杜心五	杜佳珍	父亲
王昶	王泽	父亲
阿萨法·鲍威尔	威廉·鲍威尔	父亲
朴柱英	朴成关	父亲
元瑛	孝文帝元宏	父亲
常澍田	明五	父亲
程璧光	程培芳	父亲
钟南山	钟世藩	父亲
晋武帝	司马昭	父亲
池田辉政	池田恒兴	父亲
何猷龙	何鸿燊	父亲
周坚	周士第	父亲
田中荃	田连章	父亲
爱新觉罗-福惠	雍正皇帝	父亲
张一纯	张治中	父亲
刘聪	刘渊	父亲
沈韵秋	沈定儿	父亲
冯仁亮	冯继唐	父亲
徐惠如	徐庆寿	父亲
刘万森	刘古	父亲
蒋友常	蒋孝勇	父亲
昂山	吴巴	父亲
李沛文	李济深	父亲
赵代王嘉	赵卓襄王	父亲
陈昕	陈庆之	父亲
黄笑英	黄席珍	父亲
杨小楼	杨月楼	父亲
李显龙	李光耀	父亲
洛丽塔-弗洛雷斯	安东尼奥-冈萨雷斯	父亲
刘成	刘有田	父亲
张永珍	张仲英	父亲
陈伟群	陈灿赐	父亲
洁美·李·寇蒂斯	托尼·柯蒂斯	父亲
完颜宗辅	完颜阿骨打	父亲
叶崇仁	叶志铭	父亲
张明山	张万全	父亲
华新民	华揽洪	父亲
巴沙尔-阿萨德	哈菲兹-阿萨德	父亲
余磁	李进	父亲
朱芳雨	朱应明	父亲
刘虞	刘舒	父亲
山本五十六	高野贞吉	父亲
爱德华七世	阿尔伯特亲王	父亲
阿尔贝特-威廉-海因里希	腓特烈三世	父亲
苏瑞-克鲁斯	汤姆-克鲁斯	父亲
陆子遹	陆游	父亲
碇真嗣	碇源堂	父亲
靳羽西	靳永年	父亲
阿加莎	弗雷德里克-阿尔瓦-米勒	父亲
崇祯皇帝贵妃	田弘遇	父亲
刘平	刘雨岑	父亲
奢香夫人	扯勒君亨奢氏	父亲
阳甲	祖丁	父亲
卢从史	卢虔	父亲
李必立	李秀东	父亲
孙国豪	秦汉	父亲
田家玉	田树同	父亲
德隆特·韦斯特	德尔菲那·埃蒂森	父亲
陈佐洱	陈汝惠	父亲
李重茂	唐中宗	父亲
尹恩惠	尹吕熏	父亲
张瑶华	张学友	父亲
卫出公	卫后庄公	父亲
内村航平	内村和久	父亲
张世年	张佩文	父亲
懿靖大贵妃	阿霸垓郡王额齐格诺颜	父亲
安德烈娅·佩特科维奇	佐兰·佩特科维奇	父亲
马云騄	马腾	父亲
王福山	王长林	父亲
金正勋	金善宇	父亲
朱孟炜	朱桢	父亲
孙皓	孙和	父亲
沈洋屹	沈笑世	父亲
爱新觉罗·福临	爱新觉罗·皇太极	父亲
爱新觉罗-永璜	爱新觉罗-弘历	父亲
茅忠群	茅理翔	父亲
阿卜杜拉·阿齐兹	拉赫曼	父亲
lady gaga	Joseph Germanotta	父亲
谢霆锋	谢贤	父亲
戚继光	戚景通	父亲
唐宣宗	唐宪宗	父亲
丁琪	李国强	父亲
陈俊	陈光明	父亲
顾雨童	顾天豪	父亲
朱音垫	朱徽煝	父亲
姚少娥	姚元瑞	父亲
司马衷	司马炎	父亲
蔡杭	蔡沈	父亲
林可冀	林祖烈	父亲
阿加莎-克里斯蒂	弗雷德里克-阿尔瓦-米勒	父亲
秦庄襄王	秦孝文王	父亲
村田英雄	広沢仙遊	父亲
郤克	冀缺	父亲
弗吉尼亚-伍尔夫	莱斯利-斯蒂芬爵士	父亲
李若兰	李忠诚	父亲
贺晓明	贺龙	父亲
胡安·卡洛斯一世	胡安亲王	父亲
刘筱衡	刘永春	父亲
陈建功	陈心斋	父亲
贾君	贾海平	父亲
郭子仪	郭敬之	父亲
欧阳格	欧阳竟无	父亲
季承	季羡林	父亲
麦克-辛	麦瑞克-辛	父亲
塞利姆一世	巴耶济德二世	父亲
韩烈侯	韩景侯	父亲
孙晓月	孙启明	父亲
绥靖天皇	神武天皇	父亲
萧布衣	萧大鹏	父亲
刘询	刘进	父亲
郑咏曦	郑少秋	父亲
秦茜	秦振江	父亲
列昂纳多	皮耶罗-达-芬奇	父亲
苏雨卿	李喜泉	父亲
叶企孙	叶景沄	父亲
兴信公主	唐玄宗李隆基	父亲
刘浚	刘义隆	父亲
乔治·帕潘德里欧	安德烈亚斯·帕潘德里欧	父亲
张大卫	张建宗	父亲
李克农	李哲卿	父亲
李小龙	李海泉	父亲
郑素罗	郑汉勇	父亲
冯幸耘	冯海岗	父亲
于思洋	于谦	父亲
关肃霜	关永斋	父亲
冯云山	冯绍衔	父亲
秦汉	孙元良	父亲
许冬瑾	许德仕	父亲
孙岳	孙钧卿	父亲
王献之	王羲之	父亲
爱新觉罗-弘时	雍正皇帝	父亲
刘德如	刘学增	父亲
施正杰	施国钦	父亲
约瑟芬·戈登·罗维特	丹尼斯·莱维特	父亲
刘胥	汉武帝	父亲
饶国华	饶思鸿	父亲
刘聪	刘渊	父亲
杰克-吉伦哈尔	Stephen Gyllenhaal	父亲
杨光	杨丰年	父亲
马幼禄	马富禄	父亲
陈世武	陈瑜	父亲
李在灿	李昌熙	父亲
陈凯	陈致远	父亲
慕容顗	慕容桓	父亲
铁心兰	铁战	父亲
李坚	李英	父亲
梁思顺	梁启超	父亲
杉之坊照算	津田监物-算长	父亲
秦哀公	秦景公	父亲
乔纳森利特尔	罗伯特·利特尔	父亲
陈飞宇	陈凯歌	父亲
程晓红	程元璋	父亲
蒋开发	蒋永泉	父亲
玛丽亚-凯莉	Alfred Roy Carey	父亲
祝允明	祝瓛	父亲
李兆基	李家杰	父亲
龚普生	龚镇洲	父亲
王淑媛	王隆夫	父亲
林炯灿	林拔中	父亲
安德鲁-赫胥黎	里欧纳德-赫胥黎	父亲
刘一丝	刘欢	父亲
杜佑	杜希望	父亲
长平公主	朱由检	父亲
宇文赟	宇文邕	父亲
卢正阳	卢恒之	父亲
马志明	马三立	父亲
王晓玉	王剑秋	父亲
蔡抒南	蔡继渭	父亲
马少良	马玉良	父亲
郑春华	郑成义	父亲
薛稷	薛元超	父亲
张兆旭	张衍荣	父亲
李清照	李格非	父亲
吴勇男	吴金旺	父亲
代善	努尔哈赤	父亲
杨庆煌	杨昌格	父亲
乔晓阳	乔信明	父亲
戴德生	戴雅各	父亲
俞平伯	俞陛云	父亲
张悦然	张华	父亲
楚若敖	熊咢	父亲
刘长乐	刘向一	父亲
安德烈斯-帕斯特拉纳-阿朗戈	米萨埃尔-帕斯特拉纳-博雷罗	父亲
李燕	李苦禅	父亲
黄汝碧	黄清英	父亲
兰斯·阿姆斯特朗	埃迪·古德逊	父亲
刘恭	汉惠帝刘盈	父亲
杨佩璋	杨炳煌	父亲
琦善	成德	父亲
山中鹿之介	山中满幸	父亲
渡边守纲	渡边高纲	父亲
爱新觉罗-永瑢	乾隆皇帝	父亲
朱彦?	朱膺鉖	父亲
丰臣秀吉	木下弥右卫门	父亲
塔拜	努尔哈赤	父亲
李立三	李昌圭	父亲
王令尘	王靖雄	父亲
董心怡	董建设	父亲
冯跋	冯安	父亲
曹魏废帝曹芳第三任皇后王氏	王夔	父亲
李公朴	李增培	父亲
周云鹏	周大平	父亲
宋江	宋太公	父亲
婉贵妃	陈廷璋	父亲
李中汉	李政道	父亲
朱仲芷	朱剑凡	父亲
杰奎琳·马尔斯	老弗雷斯特	父亲
阿莫德·哈默	朱利叶斯	父亲
黄燕虹	黄昌义	父亲
王艺	王刚	父亲
张灵甫	张鸿恩	父亲
如意公主	杨广	父亲
麦米·古默	唐·古默	父亲
沃伦·巴菲特	霍华德·巴菲特	父亲
李晶晶	李克潮	父亲
刘立福	刘建英	父亲
陈波儿	陈湘波	父亲
张苞	张飞	父亲
叶剑波	叶立志	父亲
史进	史太公	父亲
郑晓明	郑中元	父亲
让-卡西米尔-佩里埃	奥古斯特-卡西米尔-佩里埃	父亲
邓榕	邓小平	父亲
丁瑶	丁勉	父亲
魏学洢	魏大中	父亲
乔纳森-利特尔	罗伯特利特尔	父亲
张小曼	张西曼	父亲
乔纳森·利特尔	罗伯特利特尔	父亲
梁成恩	梁德生	父亲
玛蒂尔达-莱杰	希斯-莱杰	父亲
林姮怡	林欣荣	父亲
孝安天皇	孝昭天皇	父亲
郑一泓	郑雨水	父亲
刘履旋	刘光斗	父亲
罗颖怡	罗家宝	父亲
程善之	程桓生	父亲
俞步兰	俞振庭	父亲
曾志伟	曾启荣	父亲
杨桂枝	杨忠	父亲
武赖	吴尔汉	父亲
穆祥雄	穆成宽	父亲
阿尔萨斯·米奈希尔	泰瑞纳斯·米奈希尔	父亲
瓦氏夫人	岑璋	父亲
吴鉴泉	吴全佑	父亲
李谘	李垣	父亲
方以智	方孔炤	父亲
昂山吴	昂山	父亲
许觉	许珠	父亲
魏东	魏振雄	父亲
邢鲲	邢才芳	父亲
雷震子	姬昌	父亲
李世民	李渊	父亲
腓特烈三世	威廉一世	父亲
马尔泰-若兰	马尔泰大将军	父亲
马敬伯	马桂元	父亲
加山雄三	上原謙	父亲
周好璐	周世琮	父亲
长冈半太郎	长冈治三郎	父亲
黄兴	黄炳昆	父亲
麦克·辛	麦瑞克·辛	父亲
李丹宇	李雪峰	父亲
杨振基	杨澄甫	父亲
杨靓	杨武国	父亲
孙坚	孙匡	父亲
黄石华	黄文氏	父亲
窦威	窦炽	父亲
容志行	容宝琛	父亲
乔宗淮	乔冠华	父亲
张海涛	张继宗	父亲
陈小磊	陈云坤	父亲
杨雅卉	杨昌格	父亲
班昭	班彪	父亲
岳希新	岳升	父亲
兰陵王	文襄帝高澄	父亲
陈一文	陈依范	父亲
梅根·纳伊	罗伯特·纳伊	父亲
刘子刚	刘兆霖	父亲
刘同升	刘应秋	父亲
袁瑾	袁真	父亲
兰帕德	弗兰克-理查德-乔治-兰帕德	父亲
莱因哈特-海德里希	布鲁诺	父亲
吉穆	吉平	父亲
袁世凯	袁保中	父亲
英莲	甄士隐	父亲
孝哲毅皇后	崇绮	父亲
寿光公主	唐玄宗李隆基	父亲
吴瑞萍	吴敬仪	父亲
陈晓丽	陈旭明	父亲
查郎阿	色思特	父亲
玛格丽特二世	弗雷德里克九世	父亲
荀攸	荀彝	父亲
山下和仁	山下亨	父亲
傅灵修	傅瑜	父亲
方伟	齐秦	父亲
程玉英	程福荣	父亲
许慧玲	许兆恒	父亲
彭天戈	彭振才	父亲
关兴	关羽	父亲
杨丽华	杨坚	父亲
邓楠	邓小平	父亲
齐白石	齐良末	父亲
崔玄暐	崔综	父亲
加尔鲁什-地狱咆哮	格罗姆-地狱咆哮	父亲
弘吉剌帖古伦	脱怜	父亲
拿破仑·波拿巴	卡洛·波拿巴	父亲
王欣可	王曙光	父亲
史蒂夫-乔布斯	阿卜杜法塔赫-约翰-钱德里	父亲
廖一久	廖忠雄	父亲
谢学运	谢振乾	父亲
马克·夏卡尔	查克哈尔	父亲
密雪儿·布兰奇	David	父亲
黄秀虹	黄昌义	父亲
蔡楠	蔡思斋	父亲
元仁宗	元顺宗	父亲
汪楚宝	汪凤瀛	父亲
邓爱嘉	邓永锵	父亲
迪丽娜尔-阿布都拉	阿布都拉	父亲
费孝通	费璞安	父亲
巴蒂亚-米塔尔	米塔尔	父亲
许志华	许景南	父亲
格奥尔基·康斯坦丁诺维奇·朱可夫	康斯坦丁·安德烈耶维奇	父亲
赵明生	赵惠民	父亲
丁世忠	丁思忍	父亲
席启昭	席朝参	父亲
爱新觉罗-永璜	乾隆皇帝	父亲
爱德华五世	爱德华四世	父亲
王怡仁	王应杰	父亲
刘熙载	刘松龄	父亲
赵肃侯	赵成侯	父亲
王玉凤	王世充	父亲
柯岗	张荫南	父亲
司马英	司马迁	父亲
李淳风	李播	父亲
卢显建	卢致德	父亲
海盐公主	司马德文	父亲
麦米-古默	唐-古默	父亲
陈撄宁	陈镜波	父亲
羊献容	羊玄之	父亲
蔡宏图	蔡万霖	父亲
陈知进	陈赓	父亲
刘爷将	刘凤春	父亲
艾丹	艾青	父亲
王波明	王炳南	父亲
吴彦凝	吴为人	父亲
朱由校	朱常洛	父亲
张珍	张文祥	父亲
姬班	周顷王	父亲
赵悼襄王	赵孝成王	父亲
任正非	任摩逊	父亲
甄宝玉	甄应嘉	父亲
石柏魁	石西华	父亲
沈小宝	沈宝珠	父亲
潘序伦	潘亮之	父亲
杰米-李-柯蒂斯	托尼-柯蒂斯	父亲
孙葵林	孙佐臣	父亲
杨健侯	杨露禅	父亲
曹靖华	曹植甫	父亲
弗朗茨-斐迪南大公	卡尔-路德维希大公	父亲
刘家栋	刘斯白	父亲
侬全福	侬民富	父亲
韩念仕	张纪益	父亲
马震武	马元章	父亲
陆依萍	陆振华	父亲
李行	李玉阶	父亲
绰罗斯·猛可帖木儿	绰罗斯·乌林达	父亲
爱新觉罗·奕詥	道光帝	父亲
让-巴蒂斯-西美翁-夏尔丹	让-夏尔丹	父亲
林峰	林华国	父亲
哈米斯·卡扎菲	卡扎菲	父亲
孙双玉	孙六	父亲
梁冶中	梁稳根	父亲
李忠诚	李铁泰	父亲
王京	王天林	父亲
章存道	章溢	父亲
陈昊苏	陈毅	父亲
本多小松	本多忠胜	父亲
约翰·道奇	丹尼尔-道奇	父亲
范盛金	陈光富	父亲
临颍公主	汉和帝	父亲
蔡汉英	蔡大人	父亲
颖德八刺	元仁宗	父亲
戴维·卡梅伦	伊恩·卡梅伦	父亲
曹志鹏	曹彬	父亲
赵蕊蕊	赵怀富	父亲
苏姗-克拉腾	赫伯特-科万特	父亲
曹纯	曹炽	父亲
爱新觉罗-永璘	乾隆皇帝	父亲
马世媛	马景涛	父亲
傅履仁	傅泾波	父亲
茅盾	沈永锡	父亲
张皇后	张麒	父亲
文森特-凡-高	泰奥多勒斯-凡-高	父亲
三宝	包玉山	父亲
李民斌	李国宝	父亲
杨远大	杨建洲	父亲
三毛	陈嗣庆	父亲
聂华苓	聂洗	父亲
叶飞	叶孙卫	父亲
傅山	傅之谟	父亲
夏弥	洛基	父亲
谭友林	谭良功	父亲
黄婉	黄渝生	父亲
谢天竞	谢亚龙	父亲
沈光	沈君道	父亲
南康公主	晋明帝	父亲
许世贤	许焕章	父亲
黄磊	黄小立	父亲
窦皇后	窦毅	父亲
司马兴男	晋明帝司马绍	父亲
金-凯利	珀西-约瑟夫-凯瑞	父亲
张柏芝	张仁勇	父亲
愉贵妃	额尔吉图	父亲
李仁	李恪赐	父亲
严浩	严庆澍	父亲
邓亚萍	邓大松	父亲
蔡琰	蔡邕	父亲
吴祖强	吴瀛	父亲
陈珀	陈洁明	父亲
佩姬-约翰森	罗伯特-约翰森	父亲
布罗利	帕拉伽斯	父亲
格洛丽亚-马卡帕加尔-阿罗约	迪奥斯达多-马卡帕加尔	父亲
刘肃	刘学智	父亲
阿里-礼萨·巴列维	穆罕默德·礼萨·巴列维	父亲
朱洁	朱先水	父亲
范仲淹	范墉	父亲
徐琴芳	徐涵生	父亲
宇多田光	宇多田照实	父亲
海连池	海昌明	父亲
张为帮	张景寿	父亲
乔丹	詹姆斯	父亲
维格迪斯·芬博阿多蒂尔	芬博伊·索尔瓦德松	父亲
福雷-纳辛贝	纳辛贝-埃亚德马	父亲
董智	董建辉	父亲
汪穗中	汪松亮	父亲
梁嘉鸿	梁伟基	父亲
布莱克·莱弗利	恩尼·莱弗利	父亲
崔鹏	崔健	父亲
源赖朝	源义朝	父亲
宣统	爱新觉罗-载沣	父亲
朱孟炯	朱桢	父亲
贾充	贾南风	父亲
胡汉民	胡文照	父亲
周天	周云亮	父亲
朱誉枚	朱彦	父亲
阿兰珠	阿格巴颜	父亲
朱旭橦	朱偕浰	父亲
张向东	张晓飞	父亲
米特-罗姆尼	乔治-罗姆尼	父亲
杨念生	杨威	父亲
艾玛-斯通	Jeff Stone	父亲
秦惠文王	秦孝公	父亲
田荫亭	田士杰	父亲
陈雷	陈肇和	父亲
俞大光	俞明涣	父亲
菲利普王子	瑞典国王卡尔十六世-古斯塔夫	父亲
塔季扬娜·尤马舍娃	叶利钦	父亲
马鸿宾	马福禄	父亲
永寿公主	李显	父亲
绰罗斯·马哈木	绰罗斯·猛可帖木儿	父亲
孙福喜	孙玉兰	父亲
科菲·安南	亨利·雷金纳德·安南	父亲
齐长公主	曹睿	父亲
陈乔年	陈独秀	父亲
张作人	张倚	父亲
阎立品	阎彩云	父亲
何佩亭	何桂山	父亲
赵国泰	赵河清	父亲
刘喜奎	刘贻文	父亲
程绍迥	程昌祺	父亲
唐朝昭德皇后	王遇	父亲
东阳献公主	宋文帝	父亲
李子林	李松青	父亲
吴玠	吴扆	父亲
刘遵义	刘世达	父亲
古龙	熊飞，字鹏声	父亲
程海亭	程廷华	父亲
苏姗·克拉腾	赫伯特·科万特	父亲
吴忠性	吴显芳	父亲
乔纳森??利特尔	罗伯特-利特尔	父亲
谭芳	谭劲生	父亲
王魁武	王振元	父亲
陈瑞球	陈惠南	父亲
张小建	张远之	父亲
朱定?	朱誉荣	父亲
范冲	范祖禹	父亲
唐闻生	唐明照	父亲
吴昆	吴文韬	父亲
戈米沙	戈军	父亲
习仲勋	习宗长	父亲
吕良彪	张宏光	父亲
杨博	杨亚洲	父亲
孙立群	孙震	父亲
周叔迦	周学熙	父亲
郭麒麟	郭德纲	父亲
公孙度	公孙延	父亲
代雯奇	代晶	父亲
吕雉	吕公	父亲
查传讷	金庸	父亲
艾伦-狄珍妮	艾略特	父亲
居鲁士大帝	冈比西斯	父亲
纪容舒	纪天申	父亲
杨义	杨少华	父亲
俞扬和	俞大维	父亲
道光	清仁宗嘉庆帝	父亲
李颖	李治阳	父亲
李元嘉	李渊	父亲
林文光	林学善	父亲
保罗·高更	柯罗维斯	父亲
雷克萨	莱欧洛克斯	父亲
吴国亮	吴顺勇	父亲
霍瑞斯·道奇	丹尼尔-道奇	父亲
李勤	李壮平	父亲
纳兰嫣然	纳兰肃	父亲
刘知几	刘延佑	父亲
李来明	李占标	父亲
徐媛媛	徐涛	父亲
黄任中	黄少谷	父亲
范以程	范儒林	父亲
郑芝龙	郑绍祖	父亲
张浚	张咸	父亲
郑毓秀	郑文治	父亲
斯科特-卡彭特	马里昂斯-科特-卡彭特	父亲
丁念先	丁静斋	父亲
李尤婉云	尤菊生	父亲
本多忠胜	本多忠高	父亲
刘勃	淮南厉王	父亲
乔金-诺阿	雅尼克-诺阿	父亲
庆恭皇贵妃	陆士隆	父亲
本尼迪克特-康伯巴奇	Timothy Carlton	父亲
肖伦	肖举皋	父亲
王淑芳	王广亚	父亲
刘国梁	刘占胜	父亲
王尔烈	王缙	父亲
李书福	李艺	父亲
薇诺娜·赖德	迈克尔·霍洛维茨	父亲
启功	恒同	父亲
刘启	刘彻	父亲
威理博-司乃耳	鲁道夫-斯涅尔	父亲
付豪	付笛声	父亲
黄文斐	黄现璠	父亲
威廉-维恩	卡尔-维恩	父亲
席琳-迪翁	Adhemar	父亲
蔡宜达	蔡振华	父亲
唐玄宗李隆基的原配妻子王氏	王仁皎	父亲
琼-亨利-杜南	让-雅克-杜南	父亲
郑有英	郑心平	父亲
陈佳	陈军	父亲
彭帅	彭冀军	父亲
张悬	焦仁和	父亲
林黛玉	林如海	父亲
安格拉·默克尔	霍斯特	父亲
阔端	元太宗窝阔台	父亲
魏文亮	魏雅山	父亲
茹元俊	茹富兰	父亲
吴定谦	吴念真	父亲
征服者威廉	罗贝尔一世	父亲
古斯塔夫·路德维希·赫兹	古斯塔夫·赫兹	父亲
梁启超	梁宝瑛	父亲
权景宣	权昙腾	父亲
乌尔夫-奥伊勒	汉斯-冯-奥伊勒-歇尔平	父亲
周亚夫	周勃	父亲
王洁	王传航	父亲
格兰特·希尔	开尔文·希尔	父亲
鲁伯特·默多克	基思·默多克	父亲
陈永贵	陈志如	父亲
完颜允恭	金世宗	父亲
宋文帝	宋武帝	父亲
尹致昊	尹雄烈	父亲
黎志康	黎洪模	父亲
昂山素季 	昂山	父亲
茂德帝姬	宋徽宗	父亲
萧克	萧覃茂	父亲
陈翔	陈荣	父亲
白元鸣	白登云	父亲
武艺	武力	父亲
东乡公主	魏文帝曹丕	父亲
韩慧梅	丛竹新	父亲
李淑芬	李贺贤	父亲
田灵儿	田不易	父亲
姬阆	周僖王	父亲
安德烈·德米特里耶维奇·萨哈罗夫	德米特里·伊万诺维奇·萨哈罗夫	父亲
刘守昌	刘庸	父亲
卡拉瓦乔	费尔莫-梅里西	父亲
马廷强	马惜如	父亲
刘琼	刘本之	父亲
宋丹菊	宋德珠	父亲
黄克智	黄以诚	父亲
杨子	杨祖武	父亲
让·萨科齐	尼古拉·萨科齐	父亲
苏我马子	苏我稻目	父亲
陈朝传	陈勇	父亲
王东泰	王俊棠	父亲
刘据	刘彻	父亲
毛安之	毛宝	父亲
王少堂	王玉堂	父亲
宋成浩	宋礼源	父亲
陆定一	陆澄宙	父亲
刘岱东	刘子久	父亲
花利·格兰加	法利·格兰杰	父亲
贾宝玉	贾政	父亲
水前寺清子	林田寿	父亲
凯瑟琳·海格	保罗·海格尔	父亲
吴汝康	吴仰坡	父亲
陈阿娇	陈午	父亲
罗明	罗百历	父亲
王法慧	王蕴	父亲
陈知庶	陈赓	父亲
米特·罗姆尼	乔治·罗姆尼	父亲
戴维-卡梅伦	伊恩-卡梅伦	父亲
陈嘉庚	陈杞柏	父亲
华明	华山	父亲
刘建民	刘文瑞	父亲
李豫	李亨	父亲
中川翔子	中川胜彦	父亲
李世霖	李乐亭	父亲
刘龚	刘谦	父亲
彭祖	陆终	父亲
刘勇俊	刘建英	父亲
曹睿	曹丕	父亲
福田康夫	福田赳夫	父亲
魏国夫人	贺兰安石	父亲
达-芬奇	皮耶罗-达-芬奇	父亲
威廉·维恩	卡尔·维恩	父亲
唐少杰	唐英奇	父亲
卢星宇	卢俊卿	父亲
常乐公主	唐高祖	父亲
刘继兴	刘玉福	父亲
刘相宇	刘永行	父亲
张妙	张平选	父亲
莉泽尔-普里茨克	罗伯特-普里茨克	父亲
陈南平	陈再道	父亲
索额图	索尼	父亲
莉娜-杜汉姆	罗尔-杜汉姆	父亲
方智怡	方恩绪	父亲
戴思恭	戴士尧	父亲
白居易	白季庚	父亲
屠景明	屠钟书	父亲
王明贞	王季同	父亲
陈珊珊	陈毅	父亲
约翰·肯尼迪	帕特里克·肯尼迪	父亲
文在寅	文容型	父亲
龚廷贤	龚信	父亲
赵尚志	赵振铎	父亲
奥逊·威尔斯	理查德海德	父亲
曹胤	曹褒	父亲
杰米·雷德克纳普	哈里·雷德克纳普	父亲
李世波	李宁	父亲
张少怀	张菲	父亲
吴海燕	吴石坚	父亲
苏焕清	苏立保	父亲
阿英	钱聚仁	父亲
清仁宗	乾隆皇帝	父亲
南海十三郎	江孔殷	父亲
弗里茨-埃里希-冯-曼施坦因	爱德华-冯-李文斯基	父亲
达戈·哈马舍尔德	亚里马尔	父亲
张俭	张成	父亲
高履行	高士廉	父亲
韩简子	韩贞子	父亲
毛小青	毛泽连	父亲
三宝	包玉山	父亲
张飞	张苞	父亲
宋维栻	宋仲翱	父亲
黄正勤	黄桂秋	父亲
威廉-亚历山大-克劳斯-乔治-费迪南德	克劳斯亲王	父亲
周少华	周荣鑫	父亲
爱德华·埃弗里特	奥利佛·埃弗里特	父亲
潘有度	潘振承	父亲
母诗灏	母先强	父亲
刘宏	刘苌	父亲
克里斯-潘	雷欧-潘Leo Penn	父亲
关晓彤	关少曾	父亲
闫安	闫建军	父亲
潘香凤	潘进益	父亲
元睿宗	成吉思汗	父亲
新马师曾	邓祺	父亲
沃纳-海森堡	A．海森堡	父亲
陈立夫	陈其业	父亲
高准翼	高仲勋	父亲
张磊	张立民	父亲
陈奕迅	陈裘大	父亲
陈慧琳	陈崇伟	父亲
张慕童	张智霖	父亲
余祐	延善	父亲
陈东升	陈万林	父亲
瑚沙	纳尔察	父亲
龙造寺隆信	龙造寺周家	父亲
奥格-尼尔斯-玻尔	玻尔	父亲
顾琮	顾俨	父亲
还珠楼主	李元甫	父亲
朝鲜最高领导人	金正日	父亲
陈泰	陈群	父亲
李理华	李坚明	父亲
汪雨	汪道涵	父亲
雷洁琼	雷子昌	父亲
李宪文	李登辉	父亲
雷振华	雷喜福	父亲
刘巴	刘祥	父亲
白崇禧	白志书	父亲
盖莱蒂-久尔基	盖莱蒂-捷尔吉	父亲
小泽征悦	小泽征尔	父亲
蒲琪峰	蒲新川	父亲
秦始皇	秦庄襄王	父亲
曾纪芬	曾国藩	父亲
麦迪文	聂拉斯·埃兰	父亲
欧阳格	欧阳渐	父亲
盖叫天	张开山	父亲
王导	王裁	父亲
爱新觉罗·常颕	福临	父亲
谢淑薇	谢子龙	父亲
吉姆-沃尔顿	萨姆-沃尔顿	父亲
廖怀南	廖晖	父亲
陈伟华	陈云	父亲
莱戈拉斯·绿叶	瑟兰迪尔	父亲
杨细华	杨明财	父亲
持统天皇	天智天皇	父亲
肖丽	肖振华	父亲
翁同龢	翁心存	父亲
钱崇澍	钱剑虹	父亲
刘天健	刘炳光	父亲
爱新觉罗-胤禛	爱新觉罗-玄烨	父亲
司马繇	司马伷	父亲
张抗抗	张白怀	父亲
李振藩	李海泉	父亲
刘禅	刘备	父亲
王晶华	王占魁	父亲
秦基伟	秦辉显	父亲
张晓东	张松茂	父亲
萧国公主	唐肃宗	父亲
斯坦利-鲍德温	艾尔弗雷德??鲍德温	父亲
获嘉公主	汉明帝	父亲
卢筱嘉	卢永祥	父亲
张元生	张秀山	父亲
黄异庵	黄理彬	父亲
陈康堤	陈奕迅Eason	父亲
吴全德	吴甘霖	父亲
周越先	周春生	父亲
卞毓麟	卞献之	父亲
太原长公主	朱世珍	父亲
龚澎	龚镇洲	父亲
王明华	王顺福	父亲
陈于泰	陈一教	父亲
释小龙	陈同山	父亲
姜妙香	姜俪云	父亲
萧方略	萧绎	父亲
朱丽倩	朱金城	父亲
陈叔通	陈蓝洲	父亲
汤姆-汉克斯	艾摩斯-汉克斯	父亲
董欣年	董辅礽	父亲
马小乐	马建国	父亲
温斯顿-丘吉尔	伦道夫	父亲
蔡一清	蔡正理	父亲
尼基塔-米哈尔科夫	赛吉米亥科夫	父亲
陈植群	陈心雄	父亲
孙多慈	孙传瑗	父亲
何塞·穆里尼奥	菲力克斯·穆里尼奥	父亲
蔡葆真	蔡儒楷	父亲
玛塔-奥特加-佩雷斯	阿曼西奥-奥特加	父亲
郑梦九	郑周永	父亲
永庆公主	北宋宋太祖	父亲
杨筠	杨勇	父亲
小山梦冴	小山芳治	父亲
伊然可汗	毗伽可汗	父亲
吴其浚	吴烜	父亲
威廉三世	威廉二世	父亲
陈子美	陈独秀	父亲
易建联	易景流	父亲
罗荣桓	罗国理	父亲
毛泽东	毛贻昌	父亲
兹拉坦-伊布拉希莫维奇	efik	父亲
乔治一世	欧尼斯特-奥古斯都	父亲
卢俊宇	卢海潮	父亲
黄华国	黄天枢	父亲
秦桓公	秦共公	父亲
温恢	温恕	父亲
姜文	姜洪齐	父亲
刘玉娘	刘叟	父亲
祖逖	祖武	父亲
乔治·赫伯特·沃克·布什	普雷斯科特·布什	父亲
张晓东	张松茂	父亲
王迎萦	王洪波	父亲
陈群	荀氏	父亲
邓中夏	邓宜章	父亲
宋嘉树	韩宏义	父亲
方富元	方春仙	父亲
小小彬	温兆宇	父亲
周绍良	周叔迦	父亲
李诵刚	李章达	父亲
Hello Kitty	佐治维特	父亲
桓帝邓皇后	邓香	父亲
彭友贤	彭泰轩	父亲
杨青田	杨润福	父亲
吴珈庆	吴振忠	父亲
扬古利	郎柱	父亲
夜神月	夜神总一郎	父亲
陈玉	陈万利	父亲
佘祥林	佘树生	父亲
李鼎新	李斯志	父亲
御坂美琴	御坂旅挂	父亲
松隆子	松本幸四郎	父亲
刘金会	刘玉田	父亲
徐雪娟	徐汉棠	父亲
赵维勤	赵忠尧	父亲
刘育熙	刘北茂	父亲
慕容农	慕容垂	父亲
大久保忠世	大久保忠员	父亲
王板儿	狗儿	父亲
王昙首	东亭侯王珣	父亲
郑龙	郑明永	父亲
普拉蒂尼	阿尔多-普拉蒂尼	父亲
勃劳希契	伯恩哈德-冯-布劳希奇	父亲
杨康	杨过	父亲
慕容熙	慕容垂	父亲
曹勤	曹操	父亲
陈尊佑	陈坤	父亲
科莫娃	亚历山大·科莫夫	父亲
塔思	木华黎	父亲
松本刚明	松本十郎	父亲
连胜武	连战	父亲
周小川	周建南	父亲
斯嘉丽·约翰逊	卡斯坦·约翰逊	父亲
王大雷	王建英	父亲
廖梓源	廖厚达	父亲
郑幸娟	郑庆香	父亲
年贵妃	年遐龄	父亲
侣皓吉吉	海岩	父亲
琼·凯尔	约翰·凯尔	父亲
李千里	李恪	父亲
玄天邪帝	独孤凛	父亲
罗荣庭	罗万祥	父亲
韦紫明	迈克尔·史密斯	父亲
唐顺宗李诵嫡长女汉阳公主	唐顺宗李诵	父亲
张一弓	张长弓	父亲
黄香莲	黄铭传	父亲
袁家倜	袁克端	父亲
黄苗子	黄冷观	父亲
邹竞蒙	邹韬奋	父亲
钱元凯	钱伟长	父亲
郭淑珍	郭鸿志	父亲
朱秀昌	朱道生	父亲
托尔德·劳费尔	马克西·劳费尔	父亲
蒋孝慈	蒋经国	父亲
高百年	北齐孝昭帝高演	父亲
林中斌	林文奎	父亲
卢荫溥	卢谦	父亲
床兀儿	土土哈	父亲
史静	史玉柱	父亲
米内光政	米内受政	父亲
卡罗琳公主	兰尼埃三世	父亲
温青	洛阳富商温铭字远山	父亲
郑逸梅	震福公	父亲
李林甫	李思诲	父亲
韩文臣	韩振国	父亲
敦诚	瑚趴	父亲
芭黎丝-希尔顿	理查德-希尔顿	父亲
吉乌塞佩-罗西	菲尔迪南多-罗西	父亲
苏轼	苏洵	父亲
爱新觉罗·永璘	爱新觉罗·弘历	父亲
莫希德	苏雷什	父亲
甄英莲	甄士隐	父亲
李振华	李景唐	父亲
鲁阳公主	汉明帝	父亲
唐嘉盛	唐英年	父亲
赵柱	赵稷	父亲
冯天瑜	冯永轩	父亲
贺捷生	贺龙	父亲
吴冰	吴文藻	父亲
李艺	李书福	父亲
鄂容安	鄂尔泰	父亲
谢维军	谢育新	父亲
谭雪	谭富有	父亲
张丹枫	张宗周	父亲
许小令	许仲连	父亲
姚涞	姚镆	父亲
耶律浚	耶律洪基	父亲
蓝齐儿	爱新觉罗-玄烨	父亲
罗家宝	罗家树	父亲
邵洵美	邵恒	父亲
乔治六世	乔治五世	父亲
克里斯蒂安娜菲格雷斯	何塞·菲格里斯	父亲
爱新觉罗·弘昼	爱新觉罗·胤禛	父亲
赵昀	赵匡胤	父亲
郑厉公	郑庄公	父亲
长平公主	明思宗朱由检	父亲
吴纯耿	吴桂生	父亲
埃里希-托普	约翰尼斯-托普	父亲
杜月笙	杜文卿	父亲
胡考	胡允昌	父亲
小帕特里克-尤因	帕特里克-尤因	父亲
固伦和敬公主	爱新觉罗-弘历	父亲
爱新觉罗-代善	清太祖	父亲
谭曾鲁	谭宗培	父亲
利定昌	利荣杰	父亲
许俏妞	许雅钧	父亲
梁正群	梁修身	父亲
吴德初	吴建仁	父亲
叶崇礼	叶志铭	父亲
李禾禾	李肇星	父亲
查克·马威尼	查尔斯·B·马威尼	父亲
珍·芳达	亨利·方达	父亲
碧瑶	万人往	父亲
阿方索十三世	阿方索十二世	父亲
刘惔	刘耽	父亲
犬夜叉	犬大将	父亲
包陪庆	包玉刚	父亲
李圣根	李贤义	父亲
薛丁山	薛仁贵	父亲
李龢阳	李耀庭	父亲
司马昱	司马浚	父亲
蒋立镛	蒋祥墀	父亲
伊本·沙特	阿卜杜拉	父亲
辽道宗耶律洪基懿德皇后萧观音	萧惠	父亲
张太雷	张亮采	父亲
安德鲁·赫胥黎	里欧纳德·赫胥黎	父亲
法拉利-恩佐	阿勒法多	父亲
白薇	黄晦	父亲
爱新觉罗·永琏	爱新觉罗·弘历	父亲
盛康年	盛丕华	父亲
夏亚	吉恩·什姆·戴肯	父亲
拉迪斯劳	卡洛三世	父亲
兰世立	兰起义	父亲
克里斯蒂安·贝尔	大卫·贝尔	父亲
陈红	陈永才	父亲
张怀敏	张作霖	父亲
玻利瓦尔	胡安-维森特-玻利瓦尔	父亲
史蒂夫·戴维斯	比尔·戴维斯	父亲
王肯堂	王樵	父亲
贾永安	骆大成	父亲
田壮壮	田方	父亲
张世	张羽军	父亲
甘地	Karamchand Gandhi	父亲
易风	聂风	父亲
侯召民	侯耀中	父亲
王雪峰	王昆和	父亲
葛优	葛存壮	父亲
马君武	马衡臣	父亲
新城公主	唐太宗	父亲
徐芳芳	徐悲鸿	父亲
阎宇	阎明涵	父亲
萧玉嬛	梁武帝萧衍	父亲
龙云飞	龙被子	父亲
陈剑锋	陈子秋	父亲
蓉儿	东邪黄药师	父亲
孙维	孙大武	父亲
昭明	萧衍	父亲
约泽夫·波尼亚托夫斯基	安德热·波尼亚托夫斯基	父亲
杰西-麦特卡尔菲	Scott Metcalfe	父亲
萨曼莎·斯托瑟	托尼	父亲
顾允成	顾学	父亲
方瑀	方声恒	父亲
张寿臣	张诚甫	父亲
临晋公主	唐玄宗李隆基	父亲
张翔	张爱萍	父亲
王新亭	王光祖	父亲
杨寿山	杨中和	父亲
唐中宗嫡女	唐中宗	父亲
托津	博清额	父亲
薛刚	薛丁山	父亲
关云娣	关中	父亲
梅加瓦蒂	苏加诺	父亲
郭安宁	郭增建	父亲
杨孝亭	杨桂云	父亲
陈贞慧	陈于廷	父亲
马克-普莱尔	大卫-普莱尔	父亲
龚自珍	龚丽正	父亲
高迅	高文	父亲
郭破虏	郭靖	父亲
叶盛茂	叶福海	父亲
格伦维尔勋爵	乔治-格伦维尔	父亲
陶凯元	陶铸	父亲
冯景兰	冯台异	父亲
弗列得利克-肖邦	尼古拉-肖邦	父亲
段誉	段延庆	父亲
王静斋	王兰庭	父亲
希拉克略	老希拉克略统督	父亲
方伟	齐秦	父亲
周旋	苏调夫	父亲
玛丽·拖德	罗伯特·拖德	父亲
张立民	张开伯	父亲
晋悼公	惠伯谈	父亲
布鲁克林-贝克汉姆	大卫-贝克汉姆	父亲
丘挺	丘海洲	父亲
廖烈科	廖宝珊	父亲
陈元	陈云	父亲
张占阳	张金卯	父亲
阿道夫·威廉	威廉	父亲
黄进达	黄士心	父亲
景琏琏	景荣庆	父亲
宋芳华	宋威廉	父亲
古斯塔夫-拉尔森	拉斯-拉尔森	父亲
徐庆平	徐悲鸿	父亲
林小群	林超群	父亲
陈天字	陈定基	父亲
周伯宜	周介孚	父亲
金弘业	金大中	父亲
琼-凯尔	约翰-凯尔	父亲
于希贤	于乃仁	父亲
李胜	李休	父亲
冯秉芬	冯平山	父亲
布兰登-弗雷泽	彼得-弗雷泽	父亲
和思皇后	赵瑰	父亲
苗若兰	苗人凤	父亲
梁思宁	梁启超	父亲
张康黎	张桂平	父亲
金仙公主	唐睿宗李旦	父亲
韩赇伯	韩万	父亲
方东树	方绩	父亲
埃贡·利奥·阿道夫·席勒	约翰·卡斯帕尔	父亲
王世祥	王瑞林	父亲
李庆安	李焕	父亲
吴徵	吴伯滔	父亲
召康公	周文王	父亲
郭晓玲	郭台铭	父亲
陈涌泉	陈子贞	父亲
贯榴生	贯盛习	父亲
胡明海	胡金华	父亲
邓垦	邓绍昌	父亲
克里斯蒂亚诺-罗纳尔多-多斯桑托斯	克里斯蒂亚诺-罗纳尔多	父亲
宝庆公主	朱元璋	父亲
李向群	李德清	父亲
安德帝姬	宋徽宗	父亲
芭芭拉-贝卢斯科尼	西尔维奥-贝卢斯科尼	父亲
徐遐生	徐贤修	父亲
何彬	何尚清	父亲
嘉国公主	宋孝宗	父亲
爱新觉罗-弘庆	爱新觉罗-胤禑	父亲
支秉彝	支履谦	父亲
但杜宇	但培良	父亲
王励勤	李荣富	父亲
曹世才	曹瑞石	父亲
皮埃尔-卡西拉奇	斯蒂法诺-卡西拉奇	父亲
庞盼盼	庞建桥	父亲
斯科特-拉斯穆森	比尔-拉斯穆森	父亲
杨洁	杨伯恺	父亲
王海臣	王建廷	父亲
乐黄	乐史	父亲
谢启美	谢仁冰	父亲
敦肃皇贵妃	年遐龄	父亲
刘宝全	刘能	父亲
周海婴	鲁迅	父亲
琳恩-切尼	韦恩-埃德溫-文生	父亲
明治天皇	孝明天皇	父亲
何剑锋	何享健	父亲
卡拉-布吕尼	阿尔贝托-布吕尼-蒂戴西	父亲
李家钰	李如松	父亲
郑森	郑芝龙	父亲
张国焘	张觐王	父亲
云安公主	唐顺宗李诵	父亲
朗尼·巴克斯特	胡格斯	父亲
杨定一	杨正民	父亲
钱伟长	钱挚	父亲
张大千	张忠发	父亲
于丹丹	于凤军	父亲
李政道	李骏康	父亲
田鹏飞	田忠阳	父亲
朱由检	朱常洛	父亲
梁皓嘉	梁锦松	父亲
吴牧天	吴甘霖	父亲
曹锟	曹本生	父亲
孝昌公主	唐玄宗李隆基	父亲
王京阳	王兵	父亲
黄依妮	黄永齐	父亲
丰子恺	丰璜	父亲
赵雍本	赵孟頫	父亲
索南嘉措	南结札巴	父亲
张聪	张文亮	父亲
习近平	习仲勋	父亲
伏地魔	老汤姆·里德尔	父亲
马晨菲	马文广	父亲
艾什莉·拜登	约瑟夫·拜登	父亲
楚霄敖	熊仪	父亲
鄂伦岱	佟国纲	父亲
华佗	华文	父亲
汤用彤	汤霖	父亲
黄睿靓	黄百禄	父亲
杨勇	杨坚	父亲
塔提亚娜·塔拉索娃	阿纳托利·塔拉索夫	父亲
张善麟	张翼鹏	父亲
高桥尚子	高桥良名	父亲
周佳纳	周英华	父亲
买宝瑶	孙楠	父亲
黄秋燕	黄伯寿	父亲
李工真	李国平	父亲
吴清源	吴毅	父亲
曼拉-曼德拉	马克贾托-曼德拉	父亲
星夜	西奥多卢-梵-高	父亲
武永强	武岱林	父亲
朴周永	朴成宽	父亲
李宗仁	李培英	父亲
黛咪·洛瓦特	柏德烈·洛瓦特	父亲
达科塔-范宁	史帝夫-范宁	父亲
徐梦桃	徐学君	父亲
陈法拉	陈凤声	父亲
曼拉·曼德拉	马克贾托·曼德拉	父亲
王卿	王礼忠	父亲
寿淑帝姬	宋徽宗	父亲
王雅量	王慎	父亲
陈见飞	陈泽民	父亲
傅芬芳	傅光明	父亲
曹操	夏侯嵩	父亲
诺罗敦·西哈莫尼	诺罗敦·西哈努克	父亲
薛岳	薛豪汉	父亲
阿瑟-麦克阿瑟	老阿瑟-麦克阿瑟	父亲
肯特-奈尔森	瑟文-奈尔森	父亲
叶明	叶少兰	父亲
马克-夏卡尔	查克哈尔	父亲
莉莉-莫-辛	麦克-辛	父亲
凌青	林步随	父亲
刘信达	宋少荣	父亲
张杨杨	张岭	父亲
赵丽妃	赵元礼	父亲
韩共侯	韩哀侯	父亲
李弘冀	李璟	父亲
蜷川实花	蜷川幸雄	父亲
杨信	杨培	父亲
卡·林奈	尼尔斯·英格马森	父亲
郑板桥	郑之本	父亲
李安琦	前体操世界冠军李小平	父亲
傅紫樱	傅理成	父亲
皇甫谧	皇甫叔侯	父亲
瓦尔特·彭克	彭克·A	父亲
高瑞欣	高岗	父亲
许彭龄	许公岩	父亲
梁不疑	梁商	父亲
李青崖	李幼梅	父亲
陈碧华	陈武刚	父亲
秦英	秦怀玉	父亲
钱理群	钱天鹤	父亲
牛玉儒	牛树仁	父亲
林大椿	林启亨	父亲
朱音埑	朱徽煣	父亲
苏瑞	汤姆-克鲁斯	父亲
林月琴	林维尹	父亲
叶庆荣	叶荫章	父亲
王瑾	王吉新	父亲
李特	徐浴	父亲
蒋明允	蒋光业	父亲
马小曼	马连良	父亲
杨玄价	杨钦义	父亲
杨凝式	杨涉	父亲
阿加莎·克里斯蒂	弗雷德里克·阿尔瓦·米勒	父亲
董建成	董浩云	父亲
曹致友	曹木林	父亲
丰升额	阿里衮	父亲
周婷婷	周弘	父亲
杰奎林-玛氏	老弗雷斯特	父亲
冯亚兰	冯卫东	父亲
宋真宗	赵光义	父亲
杨小萍	杨昌格	父亲
洪深	洪述祖	父亲
泰坦	乌拉诺斯	父亲
钟少珍	钟继昌	父亲
霍焰	霍文彬	父亲
曹操	曹彪	父亲
吕志武	吕建胜	父亲
施耐庵	施元德	父亲
李典	李干	父亲
宋神宗	宋英宗	父亲
谢纲	谢振华	父亲
吕宪瑞	吕传诰	父亲
苗圃	苗德发	父亲
郑景康	郑观应	父亲
徐文盛	徐庆之	父亲
劳埃德-本特森	劳埃德-米拉德-老-本特森	父亲
黄景藏	黄卖九	父亲
纪晓岚	纪容舒	父亲
东晋王导的夫人	曹韶	父亲
爱新觉罗·纳尔苏	爱新觉罗·纳尔福	父亲
李鸿章	李文安	父亲
何尚清	何寿桢	父亲
刘咸进	刘步云	父亲
侯斌	侯殿军	父亲
白士林	白玉珍	父亲
梁思成	梁启超	父亲
华明	华山	父亲
潘安邦	潘时骅	父亲
梁赫群	梁修身	父亲
桓石虔	桓豁	父亲
段务目尘	段乞珍	父亲
刘备	刘禅	父亲
葛洪	葛悌	父亲
纳兰明珠	纳兰性德	父亲
侯瑱	侯弘远	父亲
茹绍荃	茹富兰	父亲
仁孝徐皇后	徐达	父亲
李雄	李特	父亲
郁风	郁华	父亲
古田重然	古田重定	父亲
陈明亮	陈永贵	父亲
刘芹	刘正风	父亲
和硕和恪公主	爱新觉罗-弘历	父亲
殷剑	殷崇福	父亲
耶律阿保机	德祖撒剌的	父亲
赵俊生	赵松涛	父亲
爱新觉罗-玄烨	爱新觉罗-福临	父亲
李正源	李亚力	父亲
莎拉-杰西卡-帕克	史蒂芬-帕克	父亲
叶正	叶问	父亲
玛塔-哈里	亚当-泽莱	父亲
尔东升	尔光	父亲
阿迪娜	阿的江	父亲
傅琰东	傅腾龙	父亲
马修·斯蒂文斯	莫雷尔·斯蒂文斯	父亲
贺鹏飞	贺龙	父亲
义丰公主	唐穆宗李恒	父亲
蒙毅	蒙武	父亲
黄蕙兰	黄仲涵	父亲
黄仁勇	黄廷毅	父亲
范敬宜	范承达	父亲
陈富年	陈彦衡	父亲
李大钊	李任荣	父亲
朱令	吴承之	父亲
乔治·图普五世	陶法阿豪·图普四世	父亲
文爱马	文章	父亲
赵宗复	赵戴文	父亲
黄水泉	黄金山	父亲
莉莉·艾伦	基思·艾伦	父亲
奥地利的卡尔约瑟夫大公	弗朗茨一世	父亲
穆桂英	穆柯寨	父亲
黄朝栋	黄正元	父亲
孝德天皇	茅渟王	父亲
杨彪	杨赐	父亲
张缉	张既	父亲
宋后愍公	宋庄公	父亲
孙登	孙权	父亲
胡小石	胡季石	父亲
萧誉	萧统	父亲
朱祐樘	朱见深	父亲
汤姆·洛根	梅尔文·汤姆	父亲
江泽民	江上青	父亲
亨利五世	亨利四世	父亲
武田信玄	武田信虎	父亲
冀朝铸	冀贡泉	父亲
刘维尔	克劳德-约瑟夫-刘维尔	父亲
陈大悲	陈正薇	父亲
蒋进	蒋洪乃	父亲
彭壮壮	彭云	父亲
徐锡麟	徐凤鸣	父亲
陈绍诚	陈泽宠	父亲
朱祐樬	朱见潾	父亲
刘义庆	刘道怜	父亲
方文雄	方润华	父亲
保罗·加索尔	奥古斯提	父亲
王琴侬	王仪仙	父亲
凯瑟琳·西贝利厄斯	约翰·基利根	父亲
康茂德	奥里略	父亲
敬哀皇后	张飞	父亲
颍邑公主	汉元帝	父亲
徐菊华	姚佩兰	父亲
李孝	唐高宗	父亲
尼古拉-普桑	让-普桑	父亲
爱新觉罗-常颕	福临	父亲
刘显世	刘官礼	父亲
爱新觉罗-奕詥	道光帝	父亲
夏方豪	夏永清	父亲
威廉二世	威廉公爵	父亲
弗兰克·兰帕德	老兰帕德	父亲
楼辛壶	楼狮山	父亲
徐积聪	徐德勤	父亲
加布里埃尔-马赫特	史蒂芬-马赫特	父亲
孙泰	孙匡	父亲
赵构	宋徽宗	父亲
爱新觉罗-奕詥	道光	父亲
孛儿只斤·爱牙赤	孛儿只斤·忽必烈	父亲
俞启威	俞大纯	父亲
邓朴方	邓小平	父亲
熊俊	熊汉中	父亲
堀尾吉晴	堀尾泰晴	父亲
爱丽丝-伊芙	Trevor Eve	父亲
肖方	沈千祥	父亲
王盘声	黄增福	父亲
何鲁丽	何思源	父亲
大都利行	大武艺	父亲
黄琪翔	黄富霖	父亲
徐兰沅	徐宝芳	父亲
周海江	周耀庭	父亲
孙亮	孙权	父亲
孟俊泉	孟学科	父亲
车婉婉	张英才	父亲
刘师培	刘贵曾	父亲
阿古斯汀一世	何塞-华金-德-伊图尔维德	父亲
庄岳颖	庄文腾	父亲
董翠娜	董玉亭	父亲
张无忌	铁划银钩张翠山	父亲
爱德华-惠特拉姆	Fred Whitlam	父亲
吴志泽	吴长丰	父亲
杨妃	隋炀帝杨广	父亲
王诗龄	王岳伦	父亲
孔令俊	孔祥熙	父亲
陈维崧	陈贞慧	父亲
安平公主	唐宪宗李纯	父亲
江钰源	江涛	父亲
蔡瑁	蔡讽	父亲
曹颖甫	曹秉生	父亲
明英宗朱祁镇与万宸妃之女朱延祥	明英宗朱祁镇	父亲
刘永	刘以浩	父亲
鄂宝	西柱	父亲
铃木爱理	铃木亨	父亲
尼格尔-德容	杰里-德容	父亲
威廉皇储	德皇威廉二世	父亲
莉泽尔·普里茨克	罗伯特·普里茨克	父亲
吴文俊	吴福桐	父亲
谷开来	谷景生	父亲
苏哲民	苏长泰	父亲
楚熊胜	楚熊黑	父亲
朱生豪	陆润	父亲
明智光庆	明智光秀	父亲
孙翊茜	孙志浩	父亲
王子腾	王熙凤	父亲
放勋	帝喾	父亲
董洁	董洪斌	父亲
马克-舒瓦泽	乔奇姆	父亲
卢汉	卢浚泉	父亲
叶选廉	叶宜伟	父亲
许平君	许广汉	父亲
曾志伟	曾国祥	父亲
余紫云	余三胜	父亲
宋飞	宋国生	父亲
麦克雷	吉米-麦克雷	父亲
鲁思·克利夫兰	格罗弗·克利夫兰	父亲
曼莫汉·辛格	古尔蒙克·辛格	父亲
王军	王震	父亲
陈有本	陈公兆	父亲
雒芊芊	雒启珂	父亲
卢钦	卢毓	父亲
卫国大长公主	宋太宗	父亲
刘亦菲	安少康	父亲
徐小岩	徐向前	父亲
陈盛泰	陈嘉梁	父亲
弗里德里希-威廉-尼采	卡尔-路德维希	父亲
沈万三	沈佑由	父亲
杜乂	杜锡	父亲
陆费逵	陆费炆	父亲
上官明珠	上官天	父亲
皮帕-米德尔顿	迈克尔-米德尔顿	父亲
九鬼嘉隆	九鬼定隆	父亲
李欣	李歇浦	父亲
史塔克	霍华德	父亲
查尔斯-狄更斯	约翰-狄更斯	父亲
梅葆玥	梅兰芳	父亲
阿喀琉斯	珀琉斯	父亲
张延忠	张鼎丞	父亲
张建浩	张芝泉	父亲
曹华	曹瞒	父亲
李佳白	约翰-雷德	父亲
比兰德拉·比尔·比克拉姆	马亨德拉	父亲
毕成功	毕熙东	父亲
包庭政	包伟铭	父亲
桓温	桓彝	父亲
钱韦杉	钱一飞	父亲
郑志刚	郑家纯	父亲
李明达	唐太宗	父亲
李叔同	李筱楼	父亲
桑德拉-布洛克	约翰-布拉克	父亲
丁福保	承祥公	父亲
唐太宗第十七女	唐太宗	父亲
范文程	范楠	父亲
郑鼎臣	郑国鸿	父亲
迈克尔·波伦	史蒂夫·普兰	父亲
廖语晴	廖治德	父亲
崔征	崔继昌	父亲
刘云玉	刘展鹏	父亲
窦靖童	窦唯	父亲
姬宜臼	周幽王	父亲
江长春	江世玉	父亲
萨支唐	萨本栋	父亲
刘燕玉	刘捷	父亲
李远哲	李泽藩	父亲
傅青主	傅之谟	父亲
汤唯	汤余铭	父亲
汪小亭	汪野亭	父亲
韩冬儿	韩夫子	父亲
内特·罗宾逊	杰克	父亲
吕碧城	吕凤歧	父亲
王心凌	王吉辉	父亲
冯钟璞	冯友兰	父亲
诸葛亮	诸葛圭	父亲
蒋孝刚	蒋纬国	父亲
邱文达	邱永聪	父亲
宇智波止水	宇智波镜	父亲
陈骞	陈矫	父亲
吉尔加拉德	欧洛隹斯	父亲
郭靖	郭破虏	父亲
小笠原长时	小笠原长栋	父亲
范象明	范庆荣	父亲
江世俊	江石溪	父亲
李蕙仙	李朝仪	父亲
朱自振	朱福荫	父亲
柳青	柳传志	父亲
亚克-维伦纽夫	吉尔斯-维伦纽夫	父亲
黎莉莉	钱壮飞	父亲
伍绍祖	伍云甫	父亲
李福增	李克鳌	父亲
叶宜津	叶栋梁	父亲
朱兆祥	朱正华	父亲
小托马斯·沃森	老托马斯·沃森	父亲
杨威	杨少华	父亲
杨艳	杨文宗	父亲
朱徽煠	朱楩	父亲
爱德华八世	乔治五世	父亲
李小琳	李鹏	父亲
萧铁僧	萧功卓	父亲
刘国栋	刘占胜	父亲
胡林翼	胡达源	父亲
常香玉	张福仙	父亲
柯特妮-考克斯	理查德-L-考克斯	父亲
涂少波	涂序生	父亲
奥诺雷·杜米埃	让·巴蒂斯特·杜米埃	父亲
李艾娴	李振九	父亲
唐哀宗	唐昭宗	父亲
源义经	源义朝	父亲
陈小旺	陈照旭	父亲
纯悫皇贵妃	耿德金	父亲
姜国正	姜玉均	父亲
王安忆	王愿坚	父亲
林梧桐	林石泉	父亲
赵赖	赵梦彩	父亲
张柱堂	张伯驹	父亲
渥美清	田所友次郎	父亲
周建人	周伯宜	父亲
秦宪公	秦静公	父亲
徐致靖	徐斐英	父亲
刘秀融	刘銮雄	父亲
崔罗莲	崔炳浩	父亲
黄鼎凤	黄章	父亲
范海涛	范清荣	父亲
牙忽都	薛必烈杰儿	父亲
细川玉子	明智光秀	父亲
蔡国公主	唐睿宗李旦	父亲
桥玄	桥肃	父亲
战殊	战福章	父亲
余祥铨	余天	父亲
田连元	田庆瑞	父亲
夏明霹	夏绍范	父亲
许存仁	许谦	父亲
吴印咸	吴铁秋	父亲
孟怀玉	孟绰	父亲
裴庆民	裴昌根	父亲
威廉-劳伦斯-布拉格	威廉-亨利-布拉格	父亲
瞿兑之	瞿鸿玑	父亲
阿拉贡的凯瑟琳	斐迪南二世	父亲
黎萱	黎民伟	父亲
班婕妤	班况	父亲
玛莉丝卡-哈吉塔	MickeyHargitay	父亲
郭襄	郭靖	父亲
谢杏芳	谢杰林	父亲
刘伟尔	克劳德-约瑟夫-刘维尔	父亲
乔治四世	乔治三世	父亲
包小松	包振铭	父亲
谢振南	谢霆锋	父亲
蔡澜	蔡文玄	父亲
吴斌	吴昭松	父亲
钟惠然	钟立云	父亲
定安公主	唐宪宗	父亲
司马邺	司马晏	父亲
陈淑桢	陈文龙	父亲
佩洛西	托马斯-佩洛西	父亲
谢月镜	谢重	父亲
张娟娟	张守文	父亲
李泽钜	李嘉诚	父亲
吴炳树	吴源青	父亲
王志才	王烁	父亲
哈罗德-麦克米伦	莫里斯克劳福德麦克米伦	父亲
巴达礼	土谢图汗奥巴	父亲
袁日初	袁小田	父亲
陈元	陈云	父亲
海蒂·拉玛	埃米尔基斯勒	父亲
刘沅	刘汝钦	父亲
希斯-莱杰	金-莱杰	父亲
谭望龙	谭利远	父亲
凯西-强生	罗伯特-强生	父亲
里奥·梅西	豪尔赫·梅西	父亲
林超群	林君可	父亲
任盈盈	任我行	父亲
威廉-莎士比亚	约翰-莎士比亚	父亲
陈良安	陈启达	父亲
杨守勤	杨世思	父亲
陈小田	陈道安	父亲
阎奕格	阎惠昌	父亲
吕释之	吕文	父亲
莱戈拉斯-绿叶	瑟兰迪尔	父亲
水若寒	林吉利	父亲
武延秀	武承嗣	父亲
黄莉婷	黄世文	父亲
沈盘生	沈海珊	父亲
玛丽娅	萨金特	父亲
王君如	王吉辉	父亲
格伦维尔勋爵	乔治·格伦维尔	父亲
纳伊夫-本-阿卜杜勒-阿齐兹	阿卜杜勒-阿齐兹-伊本-沙特	父亲
井伊直政	井伊直亲	父亲
龙敦	索长阿	父亲
孔令华	孔从洲	父亲
唐叔虞	周武王	父亲
万季飞	万里	父亲
唐贝诗	唐基华	父亲
潘钟祥	潘祖莹	父亲
元怿	北魏孝文帝元宏	父亲
鸠山由纪夫	鸠山威一郎	父亲
杨万里	杨芾	父亲
爱新觉罗-弘晖	爱新觉罗-胤禛	父亲
刘德祖	刘福平	父亲
金哲夫	金林兴	父亲
刘纡	刘永	父亲
上官兰心	上官鸿业	父亲
奥特里亚斯-伊萨贝拉	奥特里亚斯-马维斯特	父亲
马丁-斯科塞西	露西奥诺-查尔斯-斯科赛斯	父亲
毛岸英	毛泽东	父亲
虚竹	玄慈	父亲
孔令谦	孔少华	父亲
许仙	许仕林	父亲
张尚武	张志勇	父亲
洪炎	洪民师	父亲
南宫公主	汉景帝	父亲
宣城德公主	刘裕	父亲
丹尼斯-邓	Yuri Ten	父亲
芒努斯·卡尔森	亨里克·卡尔森	父亲
金日成	金亨稷	父亲
张猛	张纪中	父亲
马尔福	卢修斯·马尔福	父亲
朱见深	明英宗朱祁镇	父亲
珊卓-布拉克	约翰-布拉克	父亲
武丁	小乙	父亲
苏良赫	苏艺林	父亲
陈士榘	陈荣钟	父亲
和硕和恪公主	爱新觉罗·弘历	父亲
药家鑫	药庆卫	父亲
水无怜奈	伊森·本堂	父亲
辛庆忌	辛武贤	父亲
丰绅殷德	和珅	父亲
扎克·艾福龙	大卫·艾福龙	父亲
任恺	太常任昊	父亲
爱新觉罗-弘时	雍正帝	父亲
刘良	刘回	父亲
卢家骢	卢干庭	父亲
谷望江	谷景生	父亲
龙梅	吴添喜	父亲
方镇泉	方阿常	父亲
川端康成	川端荣吉	父亲
王士琴	王洪杰	父亲
舞阳公主	西晋武帝司马炎	父亲
维埃里	罗伯特	父亲
吴欣盈	吴东进	父亲
罗伯特-伯恩斯-伍德沃德	阿瑟-伍德沃德	父亲
赛义夫·伊斯兰·卡扎菲	卡扎菲	父亲
李晓林	李雪峰	父亲
杜桑-佩特科维奇	伊利亚-佩特科维奇	父亲
莉莉安-贝当古	欧仁-舒埃勒	父亲
肃明皇后	刘延景	父亲
蒂姆·托马斯	多罗西-托马斯	父亲
刘据	汉武帝刘彻	父亲
洛丽塔·弗洛雷斯	安东尼奥·冈萨雷斯	父亲
张琰	张复新	父亲
郑文公	郑厉公	父亲
诺罗敦-西哈莫尼	诺罗敦-西哈努克	父亲
加三雄三	上原謙	父亲
陈雨露	陈克正	父亲
林珠光	林云梯	父亲
刘维烈	刘履旋	父亲
吴良镛	吴仲衡	父亲
杰米-戴蒙	西奥多Theodore	父亲
陈涛	陈岳顺	父亲
唐太宗	唐高宗	父亲
卢克·沃顿	比尔·沃尔顿	父亲
程霖生	程谨轩	父亲
帕布罗-毕加索	唐-荷西-鲁伊兹	父亲
周瑜	周伯伯	父亲
刘索拉	刘景范	父亲
陆喜春	陆喜才	父亲
木谷礼子	木谷实	父亲
岳清爽	岳得志	父亲
迈克尔·道格拉斯	柯克·道格拉斯	父亲
刘叙杰	刘敦桢	父亲
格罗弗-克利夫兰	理查德-法利-克利夫兰	父亲
裴周玉	裴尧琴	父亲
冯晓泉	冯永兴	父亲
迪迪埃-塞内卡尔	阿尔贝-博达尔	父亲
沈传芷	沈月泉	父亲
荣昌公主	明神宗	父亲
蒂琵·海德伦	伯纳德卡尔赫德伦	父亲
夏明震	夏绍范	父亲
吕俊杰	吕尧臣	父亲
秦国大长公主	宋宣祖赵弘殷	父亲
洪荣宏	洪一峰	父亲
萨姆·贝拉米	史蒂芬	父亲
吴鸿昌	吴耀南	父亲
斋藤义龙	斋藤道三	父亲
延庆公主	唐武宗李炎	父亲
汤姆-克鲁斯	艾摩斯-汉克斯	父亲
寺内正毅	宇田多正辅	父亲
刘胜	刘培善	父亲
鲍惠荞	鲍国宝	父亲
连丽如	连阔如	父亲
姬午	姬嵬	父亲
李子萱	李寒羽	父亲
李靖	李诠仕	父亲
贾迎春	贾政	父亲
刘珙	刘子羽	父亲
蒋孝武	蒋经国	父亲
曹津歌	曹万林	父亲
江钰源	江涛	父亲
曾宝仪	曾志伟	父亲
陈志忠	陈彦灿	父亲
毕倚虹	毕畏三	父亲
吴珍之	吴永良	父亲
吉尔伽美什	卢伽尔	父亲
辜濓松	辜岳甫	父亲
阿萨法-鲍威尔	威廉-鲍威尔	父亲
杨岐珍	杨守恩	父亲
升平公主	唐代宗李豫	父亲
陈深	陈叔宝	父亲
阿卜杜拉·本·侯赛因	侯赛因	父亲
吕萌	吕伟进	父亲
钮祜禄-阿灵阿	钮祜禄-遏必隆	父亲
杨天经	杨占美	父亲
克努特一世	斯凡八字胡须王	父亲
夏完淳	夏允彝	父亲
伊丽莎白·贾格尔	米克·贾格尔	父亲
张圣时	张义方	父亲
李华春	李德	父亲
迈克尔·富特	艾萨克·富特	父亲
李谦	李元虎	父亲
王孟姜	王羲之	父亲
封隆之	封回	父亲
冯牧	冯承钧	父亲
公孙绿萼	公孙止	父亲
孙凤	孙英杰	父亲
王应麟	王鹏飞	父亲
晋襄公	晋文公	父亲
朱彦	朱膺鉖	父亲
约翰·丘吉尔	温斯顿·丘吉尔爵士	父亲
陈善铭	陈宝泉	父亲
李东旭	申泰焕	父亲
阴时夫	阴应梦	父亲
葛庭燧	葛启彬	父亲
张巍	张文涛	父亲
周海江	周耀庭	父亲
张海阳	张震	父亲
连惠心	连战	父亲
隋文帝杨坚与皇后孤独伽罗之女杨阿五	隋文帝杨坚	父亲
周玉	周永明	父亲
荣嫔	员外郎光保	父亲
蔡君飞	蔡冠伦	父亲
布小林	布赫	父亲
哈利·S·杜鲁门	约翰·安德森·杜鲁门	父亲
石青璇	“邪王”石之轩	父亲
皮埃尔·德·顾拜旦	夏尔·德·顾拜旦	父亲
灵思何皇后	何真	父亲
丹尼尔-汤普森	热拉尔-乌里	父亲
小奥利弗-温德尔-霍姆斯	老奥利弗-温德尔-霍姆斯	父亲
赵琦	赵稼农	父亲
马季	马子衡	父亲
何戢	何偃	父亲
杨建侯	杨露禅	父亲
杰西卡-拉德	陆克文	父亲
劳勃·瑞福	查尔斯·劳勃·瑞福	父亲
赤座直保	赤座直则	父亲
赵小兰	赵锡成	父亲
王伟忠	王志刚	父亲
吴雅童	吴德荣	父亲
周苏红	周玉国	父亲
娜塔丽·波特曼	Avner	父亲
庞云镨	庞听泉	父亲
胡乔木	胡启东	父亲
赵娥	赵君安	父亲
钟荣	钟德扬	父亲
金开芳	金文善	父亲
邢芬	邢贻存	父亲
卢荫溥	卢谦	父亲
宋希濂	宋宪文	父亲
马尔福	卢修斯-马尔福	父亲
凯特-贝金塞尔	理查德-贝金赛尔	父亲
于云霆	于谦	父亲
陈小鲁	陈毅	父亲
周广	周永明	父亲
邓程澧	邓永镛	父亲
何超仪	何鸿燊	父亲
相重扬	相菊潭	父亲
王大闳	王宠惠	父亲
许怀欣	许冠杰	父亲
李天一	李双江	父亲
契诃夫	帕维尔	父亲
工藤新一	工藤优作	父亲
杨献珍	杨延瑞	父亲
林散之	林成璋	父亲
唐统一	唐悦良	父亲
吴欢	吴祖光	父亲
章启月	章曙	父亲
乔治-安德里欧-帕潘德里欧	安德烈亚斯-乔治乌-帕潘德里欧	父亲
石连君	石长岭	父亲
诸葛怀	诸葛亮	父亲
藤川优里	藤川友信	父亲
让·保罗·萨特	让-巴浦蒂斯特·萨特	父亲
唐昭宗	父唐懿宗	父亲
纳威-隆巴顿	弗兰克-隆巴顿	父亲
钱景峰	钱小豪	父亲
杨过	杨康	父亲
郜林	郜庆丰	父亲
魏应交	魏德和	父亲
王福山	王长林	父亲
拉尔夫·舒马赫	罗尔夫·舒马赫	父亲
李文云	李凤翔	父亲
邓肇坚	邓志昂	父亲
赵杉霖	赵宏琦	父亲
谭小培	谭鑫培	父亲
金美欧	金绍平	父亲
司马德宗	司马曜	父亲
鲁思-克利夫兰	格罗弗-克利夫兰	父亲
王玉立	王柏荫	父亲
王平	王宝春	父亲
济公	李茂春	父亲
坚强妞	董建设	父亲
卡尔一世	奥托-弗朗茨大公	父亲
肖恩·阿斯廷	约翰·奥斯汀	父亲
朱家济	朱文钧	父亲
古斯塔夫二世	卡尔九世	父亲
顾恺之	顾悦之	父亲
徐国瑞	徐文元	父亲
迈克·佩勒姆	彼得·佩勒姆	父亲
王国维	王乃誉	父亲
李鹏	李硕勋	父亲
马葭	马克坚	父亲
伏地魔	老汤姆-里德尔	父亲
安德烈娅-佩特科维奇	佐兰-佩特科维奇	父亲
周嘉威	周志成	父亲
许其亮	许光达	父亲
夏建强	夏俊峰	父亲
豆卢宁	豆卢长	父亲
张维加	张云东	父亲
艾德-维斯特维克	Peter Westwick	父亲
傅起凤	傅天正	父亲
顺庆公主	宋徽宗	父亲
陈家洛	陈世倌	父亲
托马斯-戴利	罗伯特-戴利	父亲
灰原哀	宫野厚司	父亲
朱勋瀼	朱诠	父亲
李东红	李明堂	父亲
阿蒙涅姆赫特三世	辛努塞尔特三世	父亲
爱新觉罗-永瑢	爱新觉罗-弘历	父亲
王华	王希怀	父亲
王鹏	王志昌	父亲
伯特兰·皮卡德	雅克·皮卡德	父亲
金赛英	罗来龙	父亲
鲁元公主	汉高祖	父亲
奥利弗	钱伯斯	父亲
时子周	时震一	父亲
乔什-杜哈明	赖瑞-大卫-杜默	父亲
赵叔孺	赵佑宸	父亲
李伦	李克农	父亲
爱新觉罗-多尔衮	清太祖	父亲
蒋慕萍	蒋鑫棠	父亲
伊藤诚	泽越止	父亲
羽田孜	羽田武嗣郎	父亲
阿里-礼萨-巴列维	穆罕默德-礼萨-巴列维	父亲
云重	云澄	父亲
谢惠连	谢方明	父亲
邓稼先	邓以蛰	父亲
王淦昌	王以仁	父亲
邓义	邓均忠	父亲
窦妙	窦武	父亲
辜仲谅	辜濂松	父亲
刘恒斌	刘顺娥	父亲
沙尔汗	沙伯略	父亲
杨铁嗣	杨盛春	父亲
李夫人	李惠	父亲
星夜	西奥多卢·梵·高	父亲
丘良任	丘景章	父亲
薛盛忠	薛凤池	父亲
李学鹏	李锡才	父亲
安东家忠	安东连末	父亲
明仁宗	朱棣	父亲
许涤新	许远侯	父亲
王菀之	王帆	父亲
徐碧云	徐宝芳	父亲
侯佩岑	侯世宏	父亲
前田利家	前田利昌	父亲
韩宇	韩德君	父亲
崔龙海	崔贤	父亲
冯国楣	冯桂生	父亲
恩里克·弗洛雷斯	伊希德罗·桑切斯	父亲
南庚	沃甲	父亲
厉慧斌	厉彦芝	父亲
张艺谋	张秉钧	父亲
大乔	乔公	父亲
米安-穆罕默德-纳瓦兹-谢里夫	米安-穆罕默德-谢里夫	父亲
斯嘉丽-约翰逊	卡斯坦-约翰逊	父亲
维罗索	安东尼奥	父亲
李如柏	李成梁	父亲
冯玉梅	冯忠翊	父亲
和硕端柔公主	爱新觉罗-胤禄	父亲
夏淑娟	夏振堂	父亲
艾什莉-拜登	约瑟夫-拜登	父亲
李重俊	李显	父亲
黄沪芳	黄伯栋	父亲
陈伟兰	陈云	父亲
阳平公主	司马炎	父亲
福喜	周润发	父亲
林德信	林子祥	父亲
欧嘉-尼古拉耶芙娜	尼古拉二世	父亲
本杰明·富兰克林	乔赛亚·富兰克林	父亲
杜浩生	杜晓楼	父亲
天智天皇	舒明天皇	父亲
内黄公主	刘强	父亲
陆荣廷	陆业秀	父亲
姬蒂·荷姆丝	马丁·约瑟夫·霍姆斯	父亲
陈澄波	陈守愚	父亲
马修-福克斯	法兰西斯-福克斯	父亲
朴槿惠	朴正熙	父亲
朱秋魁	朱兆瑛	父亲
刘翔	刘学根	父亲
张淼	张立民	父亲
甘时然	甘士调	父亲
关颖珊	关惠棠	父亲
李孝	李治	父亲
王亚辉	王建生	父亲
唐立纪	唐茂珍	父亲
司马岳	司马绍	父亲
乔曾希	乔得寿	父亲
赵青	赵丹	父亲
陈长兴	陈秉旺	父亲
孙小林	孙少林	父亲
李小鹏	李真愚	父亲
王艺	王刚	父亲
索菲娅	法卢克·尤索夫	父亲
刘蕙瑕	刘立强	父亲
琴·格蕾	亨利·格雷	父亲
郭守正	郭台铭	父亲
项德崇	项与年	父亲
赵玉明	赵松山	父亲
许钟豪	许承会	父亲
黄崇	黄权	父亲
黄莉莉	黄大明	父亲
卢沛宁	卢正阳	父亲
孛儿只斤-爱猷识理答腊	孛儿只斤-妥懽帖睦尔	父亲
尼子敬久	尼子国久	父亲
韩晗	韩乔生	父亲
谢灵运	谢瑍	父亲
王原祁	王揆	父亲
宋子文	宋耀如	父亲
张楚怡	月阳	父亲
吉米·莱科宁	马蒂·莱科宁	父亲
李世绩	李盖	父亲
海迪·汉金斯	马修	父亲
斯坦利·鲍德温	艾尔弗雷德鲍德温	父亲
丹-艾克洛德	Peter	父亲
达奚武	达奚长	父亲
英壮	英若聪	父亲
朱企錊	朱干址	父亲
查传诗	金庸	父亲
刘召扬	刘纶	父亲
韩景侯	韩武子	父亲
项炜伊	项余岸	父亲
薛浩伟	薛长发	父亲
产保福	产桂林	父亲
戴辛尉	戴思聪	父亲
特奥-凡-杜斯堡	威廉-居伯	父亲
郭慕孙	郭承恩	父亲
唐立民	唐溥	父亲
李智云	李渊	父亲
林海峰	林国圭	父亲
巩天阔	巩汉林	父亲
郜国公主	唐肃宗李亨	父亲
张怡宁	张启源	父亲
诸葛瑾	诸葛珪	父亲
柴令武	柴绍	父亲
杨靖宇	马锡龄	父亲
固伦和静公主	爱新觉罗·弘历	父亲
林宛娴	林明成	父亲
王忠翔	王来举	父亲
张夫人	张承	父亲
万宝宝	万季飞	父亲
张剑鸣	盖叫天	父亲
小行健	罗树奎	父亲
阎守恭	阎荣	父亲
谢康	谢奕	父亲
罗锦鳞	罗念生	父亲
穆克登布	成德	父亲
王少卿	王凤卿	父亲
李昀	李焞	父亲
魏应州	魏德和	父亲
大彝震	大新德	父亲
郑成功	郑芝龙	父亲
陆维钊	陆承基	父亲
娜塔莎·艾德礼	斯图亚特·艾德礼	父亲
刘希泉	刘瑶	父亲
玛丽-玛格丽特-杜鲁门-丹尼尔	哈利-S-杜鲁门	父亲
孙怡云	孙心兰	父亲
林文光	林学善	父亲
陈丽洁	陈青远	父亲
韩伍	韩小梅	父亲
迈克尔-杰克逊	Joseph Jackson	父亲
遂安公主	李世民	父亲
张君秋	张学海	父亲
刘康祖	刘虔之	父亲
彭佩云	彭真	父亲
杨怀玉	杨文广	父亲
崔小田	崔少奎	父亲
惠若琪	惠飞	父亲
郭淑珍	郭鸿志	父亲
李世荣	李宏刚	父亲
曹景宗	曹欣之	父亲
陆昊	陆鸿生	父亲
焦少海	焦德海	父亲
瓦尔特-彭克	彭克-A	父亲
周蜜	周彤	父亲
塔拜	清太祖	父亲
朱棣文	朱汝瑾	父亲
孔庆东	孔宪知	父亲
石涛	朱亨嘉	父亲
陈佩斯	陈强	父亲
路见可	路宝琮	父亲
韩兢	韩练成	父亲
钮钴禄-嘉嘉	钮祜禄-阿灵阿	父亲
陈雨露	陈克正	父亲
邓愈	邓顺兴	父亲
卡洛尔·伦巴德	冯检基长彼得斯	父亲
张宗周	张复初	父亲
南宫问天	南宫逸	父亲
郑观应	郑文瑞	父亲
郭台铭	郭龄瑞	父亲
陈思成	陈逸恒	父亲
哀献皇女	司马衷	父亲
曾雅妮	曾茂炘	父亲
冒鹤亭	冒树楷	父亲
刘国海	刘仲良	父亲
张惠民	张子林	父亲
梁培宽	梁漱溟	父亲
乔迪·钱德勒	埃文·钱德勒	父亲
贾午	贾充	父亲
杉之坊照算	津田监物·算长	父亲
穆斯塔法·凯末尔	阿里·里札	父亲
郭艾伦	郭宏	父亲
郭槐	郭配	父亲
馆陶公主	唐高祖李渊	父亲
鸠山幸	铃木善幸	父亲
张慧	张松茂	父亲
腓特烈大帝	腓特烈·威廉一世	父亲
吴志扬	吴伯雄	父亲
董樵	董应雷	父亲
爱新觉罗-福宜	雍正皇帝	父亲
马次航	马慈航	父亲
文德皇后	长孙晟	父亲
陈永贵	陈志如	父亲
尚莉莉	尚学峰	父亲
平皋公主	汉明帝	父亲
古河渚	古河秋生	父亲
宋教仁	宋起龙	父亲
冯友兰	吴清芝	父亲
李涵秋	李朗卿	父亲
爱新觉罗-弘昼	雍正帝	父亲
林峯	林华国	父亲
王伏雄	王秉珪	父亲
戴蕴慧	戴思聪	父亲
孙岳	孙钧卿	父亲
陈小工	陈楚	父亲
拉-甘地	费罗兹-甘地	父亲
朱自清	朱鸿钧	父亲
小香香	夜太狼	父亲
司马彦	司马东	父亲
顾毓琇	顾骞明	父亲
高阳公主	李世民	父亲
杨小燕	杨开道	父亲
迈克尔-波伦	史蒂夫-普兰	父亲
杨业功	杨世凯	父亲
付洋	彭真	父亲
贾珍	贾敬	父亲
米家山	米建书	父亲
魏荣元	魏凤鸣	父亲
孔维益	孔垂长	父亲
乔治·普雷斯科特·布什	杰布·布什	父亲
释永信	刘殿爵	父亲
西格蒙德三世	John III	父亲
蓝礼-拜拉席恩	史蒂芬-拜拉席恩	父亲
任新建	任乃强	父亲
陈镜开	陈兆	父亲
孙治平	孙科	父亲
徐林胤	武强	父亲
黛安娜-范斯坦	里昂-戈德曼	父亲
普尔普	巴图济尔噶尔	父亲
赵廷美	赵弘殷	父亲
伊索克拉底	波塞冬	父亲
李忆如	李逍遥	父亲
霍尊	火风	父亲
王明	陈嘉渭	父亲
陈佳洱	陈伯吹	父亲
卡-林奈	尼尔斯-英格马森	父亲
曾国祥	曾志伟	父亲
白先勇	白崇禧	父亲
钱永刚	钱学森	父亲
李彧	李保田	父亲
爱德华一世	亨利三世	父亲
罗志祥	罗忠庆	父亲
加特简斯	比利时人	父亲
皇太极	努尔哈赤	父亲
细川忠兴	细川藤孝	父亲
高炜晟	高天峰	父亲
杨修	杨彪	父亲
徐大椿	徐养浩	父亲
王曼恬	王季范	父亲
孙绍	孙策	父亲
宋富亭	宋起山	父亲
戴澄东	戴安澜	父亲
恭怀梁皇后	梁竦	父亲
胡适	胡传	父亲
高峰秀子	平山锦司	父亲
唐英虎	唐成海	父亲
薄熙永	薄一波	父亲
路易-拿破仑-波拿巴	路易-波拿巴	父亲
王亨	王慕仁	父亲
沈跃跃	沈祖伦	父亲
马小玲	马大龙	父亲
洪天明	洪金宝	父亲
刘袆之	刘子翼	父亲
迪甘	鲍斯高·伊泽森·柏莱拉·莱特	父亲
聂宇晟	聂东远	父亲
袁家第	袁克定	父亲
小悦悦	王持昌	父亲
鲁瑞	鲁希曾	父亲
小盖叫天	盖叫天	父亲
潘陶宇	潘次山	父亲
周成程	周奇迪	父亲
德尔·波特罗	丹尼尔·德尔波特罗	父亲
孙中山	孙达成	父亲
蒙其-D-路飞	蒙奇-D-龙	父亲
陈伟强	陈耀宗	父亲
宋嘉树	韩鸿翼	父亲
陈宝琛	陈承裘	父亲
哈维尔·埃尔南德斯	哈维尔埃尔南德斯古铁雷斯	父亲
曾山	曾彩芹	父亲
杨文广	杨延昭	父亲
李暠	李昶	父亲
李瑞东	李小歧	父亲
刘君湘	李德钧	父亲
刘一丝	刘欢	父亲
施世纶	施琅	父亲
傅家俊	傅伟太	父亲
莉莉艾伦	基思-艾伦	父亲
李宓	李国成	父亲
爱新觉罗·福惠	爱新觉罗·胤禛	父亲
杨开慧	杨昌济	父亲
爱新觉罗-弘普	爱新觉罗-允禄	父亲
保科正俊	保科正则	父亲
胡籓	胡仲任	父亲
阳平公主	晋武帝	父亲
毕渊明	毕伯涛	父亲
曹志	曹植	父亲
刘中	刘光夏	父亲
迪迪埃-德库安	亨利-德库安	父亲
隆朵嘉措	增曲结	父亲
沈劲	沈充	父亲
卜舫济	卜雅各	父亲
聂叙伦	聂鸿仪	父亲
赵丽蓉	赵秉忠	父亲
李福槐	李开升	父亲
马春花	马行空	父亲
平阳公主	汉景帝刘启	父亲
李昭道	李思训	父亲
长城公主	萧衍	父亲
蒋孝勇	蒋经国	父亲
谢希德	谢玉铭	父亲
邓卓棣	邓质方	父亲
李嗣昭	李克用	父亲
黛米·洛瓦托	柏德烈·洛瓦特	父亲
王永昌	王恩普	父亲
格伦·罗宾森	克里斯蒂安布里奇曼	父亲
陈泽宠	陈立夫	父亲
宇喜多秀家	宇喜多直家	父亲
麻生太郎	麻生太贺吉	父亲
海梅·罗尔多斯·阿吉莱拉	圣地亚哥·罗尔多斯·卡拉姆	父亲
傅小石	傅抱石	父亲
伯比奇	詹姆斯	父亲
史蒂芬-库里	戴尔-库里	父亲
冯思语	冯小刚	父亲
石青璇	石之轩	父亲
赵小亭	赵松高	父亲
侣皓吉吉	侣海岩	父亲
洪为法	洪锐	父亲
金-卡戴珊	罗伯特-卡戴珊	父亲
何家华	何猷光	父亲
芭黎丝·希尔顿	理查德·希尔顿	父亲
哈米斯-卡扎菲	卡扎菲	父亲
范曾	范子愚	父亲
王余杞	王迪怀	父亲
阮葵生	阮学浩	父亲
桓济	桓温	父亲
宽仁亲王	三笠宫崇仁亲王	父亲
斯坦利-鲍德温	艾尔弗雷德鲍德温	父亲
石静宜	石凤翔	父亲
郑伦境	郑进一	父亲
奥逊-威尔斯	理查德海德	父亲
陈宇晖	陈炎桃	父亲
明宣宗	明仁宗	父亲
李目辉	李合文	父亲
魏应行	魏德和	父亲
爱新觉罗-阿济格	爱新觉罗-努尔哈赤	父亲
高仙芝	高舍鸡	父亲
昌西-比卢普斯	菲耶	父亲
陈宇慧	陈履安	父亲
安德烈-德米特里耶维奇-萨哈罗夫	德米特里-伊万诺维奇-萨哈罗夫	父亲
王徽之	王羲之	父亲
李靖	李诠仕	父亲
高更	柯罗维斯	父亲
斯蒂芬·库里	戴尔·库里	父亲
朱嘉璟	朱翔鸾	父亲
铃木善幸	鈴木善五郎	父亲
梁思达	梁启超	父亲
肖立雄	肖德明	父亲
许仕林	许仙	父亲
梁靖琪	梁家树	父亲
徐伯昕	徐元龙	父亲
克鲁兹·贝克汉姆	大卫·贝克汉姆	父亲
曾子贞	曾衍福	父亲
郑渊洁	郑洪升	父亲
满达尔汉	雅虎	父亲
张无忌	张翠山	父亲
王简姬	王遐	父亲
于长庚	于以同	父亲
金·卡戴珊	罗伯特·卡戴珊	父亲
李根	李永波	父亲
谭鑫培	谭志道	父亲
皮埃尔-保罗-普吕东	克里斯托夫-普吕东	父亲
左颖	左宗申	父亲
德隆特-韦斯特	德尔菲那-埃蒂森	父亲
卢鹤绂	卢景贵	父亲
吉格梅-凯萨尔-纳姆耶尔-旺楚克	吉格梅-辛格-旺楚克	父亲
徐熙娣	徐坚	父亲
何晨光	何卫东	父亲
陈人康	陈士榘	父亲
安立奎-伊格莱希亚斯	胡里奥-伊格莱西亚斯	父亲
宋玉麒	宋景宏	父亲
林正杰	林坤荣	父亲
张学津	张君秋	父亲
霍焰	霍文彬	父亲
刘琨	刘蕃	父亲
黄子恒	黄百鸣	父亲
丁立瀛	丁绍周	父亲
江渭清	江载文	父亲
孙祥钟	孙元良	父亲
燕侯克	燕召公	父亲
沈月	沈嘉伟	父亲
清仁宗	爱新觉罗弘历	父亲
申佳颖	申龙善	父亲
山阴公主	孝武帝	父亲
杨延嗣	杨继业	父亲
耶律浚	辽道宗	父亲
张养浩	张斯	父亲
彭德怀	彭民言	父亲
罗福苌	罗振玉	父亲
王穗明	王全国	父亲
钱学森    	钱均夫	父亲
上官皇后	上官安	父亲
盛静霞	盛炳华	父亲
杨绍明	杨尚昆	父亲
铁托-杰克森	Joseph Jackson	父亲
万春公主	唐玄宗李隆基	父亲
张瑞芝	张云镜	父亲
克莉丝·阿基诺	贝尼诺·阿基诺	父亲
王愿坚	王振千	父亲
夏尔·凡多姆海恩	文森·凡多姆海恩	父亲
冼燃	冼汉光	父亲
曹棘	曹操	父亲
韩宗文	韩维	父亲
荀彧	荀绲	父亲
皇极天皇	茅渟王	父亲
任远征	任弼时	父亲
潘怀宗	潘祖意	父亲
三世达赖	南结札巴	父亲
康懿公主	宋哲宗	父亲
焦跃进	焦裕禄	父亲
詹天佑	詹兴洪	父亲
宇文导	宇文颢	父亲
陈子昂	陈元敬	父亲
漩涡鸣人	波风水门	父亲
潘念慈	潘志寰	父亲
曹艺斌	曹善亭	父亲
靳保芳	靳元柱	父亲
李书福	李艺	父亲
中井贵一	佐田启二	父亲
曹三丰	曹格	父亲
成俊	成东日	父亲
周鸣江	周耀庭	父亲
卡拉卡拉	塞普提米乌斯·塞维鲁	父亲
小乔治-史密斯-巴顿	乔治-威廉-巴顿	父亲
周伟	周保中	父亲
玛丽二世	詹姆斯二世	父亲
林建岳	林伯欣	父亲
施聚	施忠	父亲
全庆	那清安	父亲
苏显泽	苏增福	父亲
刘田依	刘觉民	父亲
寺岛忍	尾上菊五郎	父亲
闵嗣鹤	闵持正	父亲
哈姆扎-本-拉登	本-拉登	父亲
姜桂题	姜永茂	父亲
亚历山大大帝	腓力二世	父亲
土屋昌次	金丸筑前守虎义	父亲
刘晓琨	刘昌毅	父亲
克劳迪奥·阿劳	卡洛斯·阿劳	父亲
完颜颇刺淑	金景祖	父亲
德川庆喜	德川齐昭	父亲
本愿寺显如	本愿寺证如	父亲
弗兰克-劳埃德-赖特	WilliamCaryWright	父亲
杨威	杨元品	父亲
默多克	基思-默多克	父亲
蓝薇	蓝雄	父亲
步荒	李者昌	父亲
陶宇佳	陶美阳	父亲
穆姬	晋献公	父亲
明穆宗朱载垕第三女朱尧娥	明穆宗朱载垕	父亲
李玉玺	李亚明	父亲
程言	程门	父亲
王清海	王文才	父亲
贾探春	贾政	父亲
白雪仙	白驹荣	父亲
伊莎贝尔·于佩尔	雷蒙德·于贝尔	父亲
张允和	张冀牖	父亲
刘安	淮南厉王刘长	父亲
林丹	林建斌	父亲
亚历山大-涅夫斯基	雅罗斯拉夫-弗谢沃洛多维奇	父亲
许志安	许明坤	父亲
焦守云	焦裕禄	父亲
赵献侯	赵周	父亲
胡景翼	胡彦麟	父亲
李坤仪	李宪文	父亲
门阳	门文峰	父亲
喻安澜	喻育之	父亲
曹云屏	曹渊	父亲
陈永奎	陈瑞球	父亲
哈里·胡迪尼	梅尔·山谬·怀兹	父亲
张铁林	张月亮	父亲
皮锡瑞	皮树棠	父亲
张豪龙	张仁勇	父亲
阿曼达·塞弗里德	杰克·塞弗里德	父亲
李恂	李皓	父亲
仓石武四郎	仓石昌吉	父亲
田雪松	田英章	父亲
盛静生	盛军海	父亲
李儒林	李雄武	父亲
安吉丽娜-朱丽	乔-佛伊特	父亲
威廉·戈尔丁	艾利克·戈尔丁	父亲
凯文·拉夫	斯坦·拉夫	父亲
程君谋	程十发	父亲
许海峰	许正民	父亲
王宪嫄	王偃	父亲
永泰公主	唐中宗李显	父亲
袁志敏	袁魁首	父亲
陈季常	陈希亮	父亲
埃玛·汤普森	埃里克·汤普森	父亲
颜惠庆	颜永京	父亲
马克·普莱尔	大卫·普莱尔	父亲
张晋	张桂庭	父亲
司马岳	晋明帝	父亲
丁慕冰	丁丙	父亲
张登岚	张荣斋	父亲
隋文帝	杨忠	父亲
钱煦	钱思亮	父亲
马明王	王伯万	父亲
陆鸿春	陆喜才	父亲
杨雪兰	杨光泩	父亲
蛛儿	殷野王	父亲
王吉胜	王喜喜	父亲
林赛-罗韩	迈克尔-罗韩	父亲
杨其龙	杨受成	父亲
苏育民	苏长泰	父亲
李大双	李裕舟	父亲
萧美琴	萧清芬	父亲
谭震林	谭瑞开	父亲
郭宁妃	濠人郭山甫	父亲
威廉-亚瑟-菲利普-路易斯-蒙巴顿－温莎	查尔斯王储	父亲
鲁迅	周伯宜	父亲
李廷钰	李长庚	父亲
傅斯年	傅旭安	父亲
柯有伦	柯受良	父亲
郗愔	郗鉴	父亲
米歇尔-巴切莱特	阿尔贝托-巴切莱特	父亲
沈军	沈友根	父亲
刘文辉	刘公赞	父亲
张杰尧	张武林	父亲
艾米纳姆	Marshall Bruce Mathers Jr	父亲
张默君	张伯纯	父亲
刘如意	汉高祖刘邦	父亲
曹淑	曹韶	父亲
谭世秀	谭豫志	父亲
陈健康	陈锦	父亲
艾米莉	丁斯莫	父亲
杨威利	杨泰隆	父亲
李虎	李天锡	父亲
孙鑨	孙升	父亲
钦明天皇	继体天皇	父亲
朝永振一郎	朝永三十郎	父亲
刘春红	刘宣尧	父亲
陈少敏	孙万庆	父亲
露西-哈特菲利亚	久德-哈特菲利亚	父亲
于荣强	于学忠	父亲
弗莱迪-海默	爱德华-海默	父亲
韩文侯	韩烈侯	父亲
李静训	李敏	父亲
何怡贞	何澄	父亲
阿玛雷·斯塔德迈尔	阿蒂斯·威尔逊	父亲
张幼仪	张润之	父亲
王皇后	王仁皎	父亲
克里斯蒂安娜菲格雷斯	何塞-菲格里斯	父亲
孝庄文皇后	蒙古科尔沁贝勒寨桑	父亲
唐睿宗女代国公主	唐睿宗李旦	父亲
王仲廉	王童	父亲
王筱翠	王杰	父亲
袁枚	袁滨	父亲
谢崧岱	谢宝鏐	父亲
巴勃罗-鲁伊斯-毕加索	唐-荷西-鲁伊兹	父亲
陈硕嵩	陈乾旺	父亲
琼恩-雪诺	艾德-史塔克	父亲
安国寺惠琼	武田信重	父亲
李隆基	李旦	父亲
薛嘉麟	薛济杰	父亲
江珊	江怀延	父亲
李璬	唐玄宗李隆基	父亲
冯洪达	冯玉祥	父亲
利奥波德三世	阿尔贝二世	父亲
陈元龙	陈珪	父亲
明成祖朱棣与徐皇后之女朱玉英	明成祖朱棣	父亲
阿米尔-汗	TahirHussain	父亲
陈培臣	陈舜羌	父亲
杜联齐	杜彤	父亲
尤迪特·波尔加	拉斯洛·波尔加	父亲
巴金	李小林	父亲
李鸣盛	李华亭	父亲
陈彤云	陈树人	父亲
上官婉儿	上官庭芝	父亲
李元霸	李渊	父亲
秦凯	秦钢	父亲
德皇威廉二世	腓特烈三世	父亲
沈祖显	沈佛俦	父亲
刘翼	刘开	父亲
高金素梅	金德培	父亲
阿卜杜拉-阿齐兹	拉赫曼	父亲
卡尔十六世·古斯塔夫	古斯塔夫·阿道夫亲王	父亲
孙家有	孙凤奇	父亲
同治	咸丰帝	父亲
帖木儿	塔剌海	父亲
哲悯皇贵妃	佐领翁果图	父亲
刘建民	刘文瑞	父亲
梁天	范荣康	父亲
王从希	王伟	父亲
李亚宁	李天佑	父亲
王烁	王志才	父亲
阿斗	刘备	父亲
周浩然	周孚先	父亲
邓立维	邓鸿吉	父亲
匡建二	匡一点	父亲
赵飞燕	赵曼	父亲
唯色	泽仁多吉	父亲
刘升	刘建浩	父亲
刘国正	刘邦云	父亲
周恩来	周劭纲	父亲
郎毓秀	郎静山	父亲
唐中宗李显第六女李季姜	唐中宗李显	父亲
刘芳菲	刘光宇	父亲
南造云子	南造次郎	父亲
朝鲜高宗李熙的王妃	闵致禄	父亲
杜受田	杜堮	父亲
西恩-列侬	约翰-列侬	父亲
李门	李奘图	父亲
阿尔贝·亚历山大·路易·皮埃尔·格里马尔迪	兰尼埃三世亲王	父亲
张庆伟	张荣时	父亲
胡耀福	胡祖仑	父亲
余姚公主	梁简文帝	父亲
薛世恒	薛济杰	父亲
石凌鹤	石国磐	父亲
唐宪宗女安平公主	唐宪宗李纯	父亲
张悟本	张宝杨	父亲
史蒂夫-乔布斯	Abdulfattah	父亲
沈之荃	沈鸿模	父亲
陈彪	陈体诚	父亲
王阮	彦傅	父亲
浦通修	浦友梧	父亲
温瑞安	温伟民	父亲
冯克嘉	冯振玺	父亲
温娉婷	温孝廉	父亲
阿隆索	佩里克-阿隆索	父亲
贾马尔-桑普森	拉尔夫-桑普森	父亲
林立衡	林彪	父亲
王赐豪	王仲铭	父亲
魏莲芳	魏永发	父亲
林晓阳	徐启德	父亲
席鲁思	席业	父亲
李瀚章	李文安	父亲
查尔斯·马丁·霍尔	赫曼·巴赛特·霍尔	父亲
咸丰	清宣宗道光帝	父亲
李兆会	李海仓	父亲
噶尔汉	噶达浑	父亲
大谷吉继	大谷盛治	父亲
黎萨尔	佛朗西斯科-梅尔卡多	父亲
沈玉秋	沈福海	父亲
黎民伟	黎兆昆	父亲
小杨月楼	杨天宝	父亲
王健	王树棠	父亲
韩宣子	韩厥	父亲
徐沅澔	徐小明	父亲
诸邑公主	汉武帝	父亲
许世友	许存仁	父亲
穆凯什-阿姆巴尼	迪鲁拜-阿姆巴尼	父亲
王杰	王侠	父亲
韩金福	韩乐卿	父亲
顾维钧	顾溶	父亲
周淑英	周永明	父亲
羊徽瑜	羊衜	父亲
魏华存	司徒魏舒	父亲
齐宣王	齐威王田因齐	父亲
董文忠	董俊	父亲
陈桃川	陈澹浦	父亲
汤子嘉	汤君年	父亲
张绍	张飞	父亲
刘伯明	刘志生	父亲
切斯-克劳福德	Chris Crawford	父亲
符思思	符敦佳	父亲
郭晶晶	郭树忠	父亲
张树声	张荫谷	父亲
森兰丸	森可成	父亲
李哲思	李兵	父亲
许援朝	许世友	父亲
瓦妮莎-雷德格瑞夫	迈克尔爵士	父亲
比兰德拉-比尔-比克拉姆	马亨德拉	父亲
蒂亚戈·阿尔坎塔拉	马津霍	父亲
唐令则	唐谨	父亲
丁景唐	丁良骏	父亲
席维斯-史泰龙	弗兰克-史泰龙	父亲
爱新觉罗·赛音察浑	康熙	父亲
明世宗	朱佑杬	父亲
赵幼斌	赵斌	父亲
赵文子	赵朔	父亲
郭瑶瑶	郭来兴	父亲
孙全霞	侯晓锋	父亲
王治郅	王维君	父亲
秋瑾	秋寿南	父亲
丁爱平	丁金度	父亲
曾凡一	曾溢滔	父亲
亚森-罗平	泰奥弗拉斯特-罗平	父亲
李杭	李苦禅	父亲
蒋伯斧	蒋清朔	父亲
和硕和婉公主	爱新觉罗-弘昼	父亲
小花玉兰	陈艳楼	父亲
赵敏	察罕帖木儿	父亲
李葆华	李大钊	父亲
刘肥	刘邦	父亲
陈楚河	陈启礼	父亲
詹斯梅·迈克·乔丹	迈克尔·乔丹	父亲
武穆皇帝元怀之女	武穆皇帝元怀	父亲
张晨	张友生	父亲
夏徵舒	夏御叔	父亲
劳拉-德克尔	迪克-德克尔	父亲
王熙凤	王子腾	父亲
成龙	房祖名	父亲
帕布罗·毕加索	唐·荷西·鲁伊兹	父亲
茹绍魁	叶盛章	父亲
梁敦厚	梁善济	父亲
文成公主	李世民	父亲
刘淇	刘少奇	父亲
朴周永	朴成宽	父亲
爱新觉罗-弘瞻	爱新觉罗-胤禛	父亲
越民义	越国祥	父亲
章建东	章达	父亲
顾鹤逸	顾廷烈	父亲
刘锦向	刘贤	父亲
威廉一世	罗贝尔一世	父亲
梁康伯	秦仲	父亲
艾思奇	李曰垓	父亲
唐宪宗嫡妻懿安郭皇后	郭暧	父亲
黎锦辉	黎培銮	父亲
杨恭懿	杨天德	父亲
任小蕾	任永华	父亲
曾馨莹	曾胜煌	父亲
林莉	林维良	父亲
乾隆	清世宗雍正帝	父亲
光武郭皇后	郭昌	父亲
王菲	王佑林	父亲
朱谟墡	朱融焚	父亲
林峰	林华国	父亲
阎若璩	阎修龄	父亲
罗通	罗成	父亲
高韵芬	高连甲	父亲
杰拉德·皮克·伯纳乌	约翰	父亲
陈杰	陈泽彬	父亲
李纨	李守中	父亲
潘岳	潘田	父亲
申后	申侯	父亲
陈霸先	陈文赞	父亲
徐城北	徐盈	父亲
小弗雷迪-普林兹	弗雷迪-普林斯	父亲
阳安公主	汉桓帝刘志	父亲
查传倜	金庸	父亲
魏磊	魏一鸣	父亲
彭桓武	彭树棠	父亲
孝庄文皇后	寨桑·布和	父亲
陆祥林	陆银全	父亲
刘至翰	刘尚谦	父亲
陈沫吾	陈正贵	父亲
张又侠	张宗逊	父亲
马唯中	马英九	父亲
郦邑公主	汉光武帝	父亲
庞世奇	庞兆元	父亲
中岛美雪	中岛真一郎	父亲
曹楷	曹芳	父亲
刘弥群	刘伯承	父亲
王铁树	王彦学	父亲
陈嘉然	陈永奎——YGM贸易主席	父亲
蔡柏龄	蔡元培	父亲
梁从诫	梁思成	父亲
庄思敏	庄宝	父亲
王皃姁	王仲	父亲
柔福帝姬	赵佶	父亲
许还山	许凌青	父亲
富士八郎	仓木麻衣	父亲
李卫	李宗靖	父亲
莱西·察伯特	汤尼·察伯特	父亲
王朔	王志才	父亲
尤迪特-波尔加	拉斯洛-波尔加	父亲
马季	马东	父亲
奚中路	奚延宏	父亲
周吕鑫	周默	父亲
陈中	陈新生	父亲
王蕙芳	王聚宝	父亲
永世公主	萧衍	父亲
宇文恺	宇文贵	父亲
菲丝-希尔	Ted	父亲
张泽鹏	张思聪	父亲
陈撷芬	陈范	父亲
安吉·穆洛兹	马斯	父亲
刘力贞	刘志丹	父亲
姜文龙	姜云飞	父亲
殷剑平	殷千炀	父亲
道武帝	拓跋寔	父亲
杨宗保	杨延昭	父亲
贾环	贾政	父亲
黎小田	黎草田	父亲
王小亚	王兆乾	父亲
曹栋	曹彦军	父亲
唐丹	唐世叶	父亲
断灭阐提	魔皇	父亲
爱新觉罗·弘旺	爱新觉罗·胤禩	父亲
陈友谅	陈普才	父亲
郭可盈	郭达昌	父亲
康静谷	康有为	父亲
吕清森	吕明俊	父亲
马步青	马麒	父亲
林伯渠	林鸿仪	父亲
新安穆公主	萧顺之	父亲
陈瑀	陈球	父亲
皮埃尔-德-顾拜旦	夏尔-德-顾拜旦	父亲
克里斯蒂娜·费尔南德斯·德基什内尔	埃杜阿尔多·费尔南德斯	父亲
中川昭一	中川一郎	父亲
道格拉斯·麦克阿瑟	小阿瑟·麦克阿瑟	父亲
王竹溪	王才俊	父亲
新丰公主	元怀	父亲
黄钧庭	黄辛温	父亲
源实朝	源赖朝	父亲
明太祖朱元璋与马皇后之女	朱元璋	父亲
蒋万安	蒋孝严	父亲
布里奇曼	雷蒙德·兰登·布里奇曼	父亲
宋任穷	宋国珍	父亲
麦克·波拉科夫斯	尼可莱	父亲
叶开	白天羽	父亲
林汉雄	林育英	父亲
苗立杰	苗荣福	父亲
林元珠	林淑钦	父亲
林志玲	林繁男	父亲
钱学森	钱均夫	父亲
高思博	高育仁	父亲
草薙京	草薙柴舟	父亲
王卿	王礼忠	父亲
刘仕谔	刘子华	父亲
韦应物	韦銮	父亲
夏延·基德	贾森·基德	父亲
陈格	陈道明	父亲
吉尔伯特-基思-切斯特顿	Edward	父亲
兰斯-阿姆斯特朗	埃迪-古德逊	父亲
安少康	刘亦菲	父亲
向华胜	向前	父亲
贾敏	贾代善	父亲
亚历山大罗维奇	弗拉基米尔	父亲
白晓红	白秀雄	父亲
司马楚之	司马荣期	父亲
徐宝全	徐宾辉	父亲
洪刍	洪民师	父亲
曹锡龄	曹学闵	父亲
上官小妹	上官安	父亲
鲍河杨	管桦	父亲
李明博	李忠宇	父亲
荣文蔚	荣智鑫	父亲
李泽楷	李嘉诚	父亲
刘伯承	刘文炳	父亲
徐枕亚	徐懋生	父亲
孔仲起	孔小瑜	父亲
由布惟信	由布惟巍	父亲
阿瑟-韦尔兹利	莫宁顿伯爵第一	父亲
弗拉迪斯拉夫三世	弗拉迪斯拉夫二世	父亲
米友仁	米芾	父亲
小乔	乔公	父亲
张丽莉	张爱	父亲
蒋兆鲲	蒋德璟	父亲
刘向	刘歆	父亲
伯颜	晓古台	父亲
达戈-哈马舍尔德	亚里马尔	父亲
孔继宁	孔令华	父亲
乔荩臣	乔景岱	父亲
裴行俭	裴仁基	父亲
闻占萍	闻子芳	父亲
陈金钟	陈笃生	父亲
马克-麦道夫	伯纳德-麦道夫	父亲
一休	后小松天皇	父亲
张学友	张作琪	父亲
仲崇信	仲伟仪	父亲
于盈	于幼军	父亲
荣德帝姬	宋徽宗	父亲
朱文圭	朱允炆	父亲
张栩	张远锡	父亲
洪映早	洪贤哲	父亲
卢晓	卢永亮	父亲
金正恩	金正日	父亲
贾曾	贾言忠	父亲
周武王	周文王	父亲
维格迪斯-芬博阿多蒂尔	芬博伊-索尔瓦德松	父亲
尉迟乙僧	尉迟跋质那	父亲
宁妃	武柱国	父亲
居斯塔夫·莫罗	路易-让·玛丽·莫罗	父亲
塞内卡尔	阿尔贝	父亲
黎健图	黎洪模	父亲
安娜·盖蒂	约翰·保罗·盖蒂	父亲
固伦和静公主	乾隆皇帝	父亲
何宁	何贤省	父亲
阮元龙	阮庆祥	父亲
怀恩	戴希文	父亲
陈蓉芳	陈嘉麟	父亲
钟期光	钟开寿	父亲
张仲	张惠清	父亲
金紫薇	金沙	父亲
赛义夫-阿拉伯-卡扎菲	奥马尔-穆阿迈尔-卡扎菲	父亲
水无怜奈	伊森-本堂	父亲
何超云	何鸿燊	父亲
尼古拉-特斯拉	米卢廷-特斯拉	父亲
汪长诗	汪德官	父亲
王继鹏	王延钧	父亲
爱新觉罗-努尔哈赤	爱新觉罗-塔克世	父亲
微子	帝乙	父亲
爱新觉罗-奕詝	爱新觉罗-旻宁	父亲
方心芳	方殿铭	父亲
陈尧佐	陈省华	父亲
安东尼-亨利-贝克勒尔	亚历山大-爱德蒙-贝克勒尔	父亲
汪艺珉	汪小亭	父亲
曾振庭	车汉文	父亲
刘维宁	刘允斌	父亲
李嫱冰	李晓东	父亲
阿尔松阿	钮祜禄·阿灵阿	父亲
张恩溥	张元旭	父亲
李小可	李可染	父亲
古斯塔夫二世·阿道夫	卡尔九世	父亲
陈耕耘	陈长兴	父亲
邱议莹	邱茂男	父亲
舒桐	舒茂林	父亲
李乐	李富荣	父亲
王茜	王达武	父亲
顾圣婴	顾高地	父亲
张闾蘅	张学森	父亲
陈晓林	陈先水	父亲
李蒙	李振亚	父亲
杰西·斯宾塞	罗德尼·斯宾塞	父亲
玛丽-唐纳森	约翰-唐纳森	父亲
王王晃	王应桃	父亲
马凤图	马捷元	父亲
朱有熼	朱橚	父亲
孙胜男	孙春来	父亲
阿莱克斯-张伯伦	马克-张伯伦	父亲
李门	李奘图	父亲
白晓红	白秀雄	父亲
托尔德-劳费尔	马克西-劳费尔	父亲
黄蓉	黄药师	父亲
爱新觉罗-赛音察浑	康熙	父亲
毛利辉元	毛利隆元	父亲
沃尔特-布朗	乔治-V-布朗	父亲
崔才人	崔弘道	父亲
陈元龙	陈梅庵	父亲
黄宾虹	黄定华	父亲
亚历山德拉-费奥多萝芙娜	路德维希四世	父亲
包天笑	包韵竹	父亲
赵飞	赵鸣深	父亲
姬发	周文王	父亲
艾南·塞利斯特·考雷	瓦伦丁·考雷	父亲
吉姆-沃尔顿	山姆-沃尔顿	父亲
献穆曹皇后	曹操	父亲
常东	常和	父亲
晏子	晏弱	父亲
林高远	林建宇	父亲
查理-罗贝尔	查理-德-安茹	父亲
李重美	李从珂	父亲
懿安皇后	张国纪	父亲
姚金男	姚建平	父亲
奥逊-威尔斯	理查德-海德	父亲
孔亮	孔太公	父亲
白灵	白玉祥	父亲
李玉声	李洪春	父亲
里奥-梅西	豪尔赫-梅西	父亲
金正云	金正日	父亲
傅皇后	傅宴	父亲
郑宇龙	郑智	父亲
黄伦硕	黄润室	父亲
单田芳	单永奎	父亲
小萝卜头	宋绮云	父亲
周天池	周振宇	父亲
卫声公	卫慎公	父亲
科林-麦克雷	吉米-麦克雷	父亲
夏侯楙	夏侯惇	父亲
李宗瑞	李岳苍	父亲
爱新觉罗-弘昀	雍正皇帝	父亲
冯亚楠	冯华谦	父亲
卡卡	鲍斯高-伊泽森-柏莱拉-莱特	父亲
石玉明	袁生木	父亲
固伦和敬公主	乾隆皇帝	父亲
杨化然	杨威	父亲
东条英教	东条英俊	父亲
周文	周继先	父亲
拓跋虔	拓跋纥根	父亲
古在由秀	古在由正	父亲
张翼鹏	盖叫天	父亲
武姜	申侯	父亲
白浪	白帆	父亲
蔡道行	蔡云辉	父亲
朱世藕	朱国梁	父亲
车晓	车晓彤	父亲
明太祖朱元璋第十一女	明太祖朱元璋	父亲
苏盛轼	苏雨卿	父亲
蒲松龄	蒲盘	父亲
苏芮-克鲁斯	汤姆-克鲁斯	父亲
路易十七	路易十六	父亲
曹摅	曹休	父亲
夏荫培	夏月润	父亲
黄烽	黄晋望	父亲
宋世荣	宋永禄	父亲
曾宝荪	曾广钧	父亲
卢晓	卢永亮	父亲
徐嘉惠	徐斌	父亲
齐良末	齐白石	父亲
孙武	孙凭	父亲
郑小箴	郑振铎	父亲
邛成太后	王奉光	父亲
胡雪岩	胡洪钺	父亲
隋炀帝皇后萧氏	萧岿	父亲
莉莉·莫·辛	麦克·辛	父亲
郝艳霞	郝英吉	父亲
陈延年	陈独秀	父亲
徐建威	徐德铨	父亲
修庆	修正宇	父亲
雍舜	对齐巴颜	父亲
爱新觉罗-皇太极	清太祖	父亲
小昭	韩千叶	父亲
傅海峰	傅铭英	父亲
江户川柯南	工藤优作	父亲
小王桂卿	王桂卿	父亲
艾莉森-威廉姆斯	布莱恩-威廉姆斯	父亲
玄清	隆庆帝	父亲
安德鲁-克尼格	沃尔特-克尼格	父亲
瞿文楼	瞿子安	父亲
丁汝昌	丁灿勋	父亲
周星驰	周驿尚	父亲
孙匡	孙坚	父亲
沈健谨	沈金波	父亲
寿岳润	寿岳文章	父亲
徐伟栋	徐少强	父亲
陈布达	陈强	父亲
霍羽佳	翟善从	父亲
罗杰·费德勒	罗伯特·费德勒	父亲
许雅钧	许庆祥	父亲
王晶	王天林	父亲
言兴朋	言少朋	父亲
秋山真之	秋山久敬	父亲
布莱丝·达拉斯·霍华德	朗·霍华德	父亲
王淑贞	王季同	父亲
慕容超	慕容纳	父亲
嘉庆	乾隆帝	父亲
杨议	杨少华	父亲
李四广	李顺德	父亲
邱钟惠	邱天培	父亲
绰罗斯-马哈木	绰罗斯-猛可帖木儿	父亲
李商隐	李嗣	父亲
坦维尔·布拉尔	阿维塔·布拉尔	父亲
唐宾	唐振武	父亲
王心如	王昆仑	父亲
马延凌	马立安	父亲
毛宝	毛安之	父亲
乔瑛	桥国老	父亲
加内特	奥-刘易斯-加内特	父亲
任远芳	任弼时	父亲
卢星宇	卢俊卿	父亲
陈青远	陈仲山	父亲
巴沙尔·阿萨德	哈菲兹·阿萨德	父亲
夏绍笙	夏时济	父亲
孛儿只斤·奥都赤	孛儿只斤·忽必烈	父亲
张希	张广骏	父亲
周晓峰	周辞美	父亲
朱兆祥	朱正华	父亲
Ariel HO-KJAER	何超贤	父亲
多米尼克-莫纳汉	奥斯汀-莫纳汉	父亲
太华公主	唐玄宗李隆基	父亲
弗朗西斯科·法布雷加斯	法兰西斯克·法布雷加斯	父亲
史万岁	史静	父亲
文洁若	文宗淑	父亲
王元纲	王福山	父亲
司汤达	舍吕宾-约瑟夫-贝尔	父亲
董军	董继昌	父亲
苏富恩	苏雨卿	父亲
章小蕙	章建国	父亲
陈泽民	陈见飞	父亲
郭小波	郭全民	父亲
余苑绮	余天	父亲
杨艳	杨文宗	父亲
侯丹梅	侯剑光	父亲
秦卫江	秦基伟	父亲
周璟馨	周令飞	父亲
小乔治·史密斯·巴顿	乔治·威廉·巴顿	父亲
司马衍	司马绍	父亲
奥黛莉-赫本	约瑟夫-维克特-A-赫本-鲁斯顿	父亲
黄新	黄有龙	父亲
陈澄	陈德林	父亲
和田惠美	野口信男	父亲
阎世善	阎岚亭	父亲
阿尼尔·阿姆巴尼	迪鲁拜·阿姆巴尼	父亲
和硕淑慎公主	雍正皇帝	父亲
阿瑞斯	宙斯	父亲
藤原仲麻吕	藤原武智麻吕	父亲
张良烈士	张兆喜	父亲
李处耘	李肇	父亲
汪福熙	汪宗沂	父亲
郑岩	郑伟业	父亲
张娴	张柏生	父亲
洪天祥	洪金宝	父亲
艾伦-佩姬	Dennis	父亲
何超琼	何鸿燊	父亲
德世库	福满	父亲
周作人	周伯宜	父亲
白建桥	白老合	父亲
伊丽莎白·泰勒	弗朗西斯·泰勒	父亲
仪琳	不戒和尚	父亲
沈谦	沈钧儒	父亲
小帕特里克·尤因	帕特里克·尤因	父亲
鲁幽公	鲁炀公	父亲
乔迪-钱德勒	埃文-钱德勒	父亲
张箐	张春萍	父亲
乌汶叻公主	普密蓬-阿杜德	父亲
刘慧琴	刘培山	父亲
辛博森	辛盛之	父亲
马占山	马纯	父亲
赫连勃勃	刘卫辰	父亲
海梅·罗尔多斯·阿吉莱拉	玛莎·罗尔多斯·卡拉姆	父亲
章怀皇后	潘美	父亲
太平公主	唐高宗	父亲
万年公主	汉灵帝	父亲
庞飞燕	庞太师	父亲
杨纪华	杨秉彝	父亲
沈寿林	顺福	父亲
陈登恪	陈三立	父亲
张浩源	张朗	父亲
张天杰	张剑原	父亲
安妮·考克斯·钱伯斯	詹姆斯·M·考克斯	父亲
切斯特-艾伦-阿瑟	威廉-亚瑟	父亲
陈鹤年	陈独秀	父亲
王仪涵	王子华	父亲
陈志皋	陈其寿	父亲
延庆公主	明穆宗朱载垕	父亲
萧定一	萧若元	父亲
焦宝宏	焦铭钰	父亲
周波	周新国	父亲
普密蓬-阿杜德	玛希敦-阿杜尔雅戴	父亲
杨文婷	杨三俊	父亲
李善兰	李祖烈	父亲
裴子野	裴昭明	父亲
孟云卿	孟浩然	父亲
杨文广	杨宗保	父亲
刘蔷	刘继卣	父亲
徐秉言	徐素白	父亲
杨会康	杨东禄	父亲
熊育钖	熊光祖	父亲
夏延-基德	贾森-基德	父亲
高晓东	高德康	父亲
梁思礼	梁启超	父亲
吴国冲	吴乃顺	父亲
李素节	唐高宗李治	父亲
冯至	冯文澍	父亲
曹晋云	曹显政	父亲
佐川一政	佐川明氏	父亲
朱以海	鲁肃王朱寿镛	父亲
汪永铨	汪奠基	父亲
刘康	汉元帝刘奭	父亲
颜以燠	颜模	父亲
莎拉-布莱曼	Grenville Brightman	父亲
玛哈·扎克里·诗琳通	普密蓬·阿杜德	父亲
李恪	唐太宗李世民	父亲
杨一清	杨景	父亲
葛慧君	葛洪升	父亲
潘鼎新	潘月樵	父亲
邓楠	邓小平	父亲
小红	林之孝	父亲
奥地利的卡尔&#12539;约瑟夫大公	弗朗茨一世	父亲
哪吒	托塔李天王	父亲
陈香梅	陈应荣	父亲
姜云凡	姜世离	父亲
袁克权	袁世凯	父亲
刘明夏	刘英	父亲
江泽慧	江上青	父亲
韩方奕	韩家敏	父亲
蒂姆·邓肯	威廉姆·邓肯	父亲
威廉一世	罗贝尔一世	父亲
邱峻	邱鑫	父亲
李崇道	李骏康	父亲
韦唯	张玉	父亲
陆凤琴	陆连贵	父亲
朱厚照	朱祐樘	父亲
陈敬贤	陈杞柏	父亲
班固	班彪	父亲
任月丽	任永生	父亲
潘曾莹	潘世恩	父亲
朱莉娅·吉拉德	约翰·吉拉德	父亲
西汉定陶恭王	汉元帝刘奭	父亲
华轶	华澹	父亲
金承佑	金时英	父亲
李太后	李伟	父亲
西尔维娅-索莫莱特	瓦尔特-索莫莱特	父亲
汉武帝第五子燕剌王	汉武帝	父亲
弗吉尼亚·伍尔夫	莱斯利·斯蒂芬爵士	父亲
侯军	侯耀华	父亲
爱新觉罗-多尔衮	努尔哈赤	父亲
伊丽莎白-贾格尔	米克-贾格尔	父亲
邹家华	邹韬奋	父亲
王润身	王魁武	父亲
黄薇	黄德嘉	父亲
张志勇	张尚武	父亲
钱仲联	钱滮	父亲
许天虎	许耀庭	父亲
王荣山	王永成	父亲
陈淑容	陈荣盛	父亲
张尚武	张志勇	父亲
杨坚	杨忠	父亲
吴靖	吴熙元	父亲
李仁友	李乾顺	父亲
克里斯多夫·杜德	汤玛斯·约瑟夫·杜德	父亲
范维澄	范治纶	父亲
常宝丰	常连安	父亲
罗伊德-沙普利	Harlow Shapley	父亲
熊浩然	熊忠武	父亲
许霆	许彩亮	父亲
宁国公主	朱元璋	父亲
唐彬如	唐常吉	父亲
淯阳公主	汉光武帝	父亲
沈默	沈贺	父亲
耿炳文	耿君用	父亲
赵连喜	赵秉忠	父亲
郗昙	郗鉴	父亲
段浩川	段希文	父亲
万毅	万宝贵	父亲
彼得大帝	阿列克谢一世	父亲
姜藤	姜克军	父亲
陈超	陈玉军	父亲
韩素音	周映彤	父亲
爱新觉罗-永琮	乾隆皇帝	父亲
朱屺瞻	朱大坤	父亲
迈克尔	乔-杰克逊	父亲
郭祥忍	郭功森	父亲
吴昊思	吴琏	父亲
郭树忠	郭晶晶	父亲
秦连光	Dad	父亲
金正恩	金正日	父亲
魏斐徳	弗里德里克·魏克曼	父亲
贾珠	贾政	父亲
明穆宗朱载垕第六女朱尧姬	明穆宗朱载垕	父亲
李凡	李春阳	父亲
贺皇后	东部大人贺野干	父亲
杰拉德	弗烈德里克-飞利浦	父亲
包晓泉	包玉堂	父亲
张克澄	张维	父亲
吴玉章	吴世敏	父亲
罗小奎	罗文奎	父亲
郭振东	郭长义	父亲
申奥	申军谊	父亲
米歇尔·巴切莱特	阿尔贝托·巴切莱特	父亲
鲁比娜·阿里	拉菲克·库雷希	父亲
许冠杰	许世昌	父亲
保罗-塞尚	路易-奥古斯都-塞尚	父亲
张震	张国柱	父亲
郑苇如	郑直	父亲
张光东	张云逸	父亲
崔世安	崔德胜	父亲
威廉-戈尔丁	艾利克-戈尔丁	父亲
姬扁	姬骄	父亲
孙元良	孙廷荣	父亲
武承嗣	武元爽	父亲
英琪	英若诚	父亲
郑法祥	郑长泰	父亲
霍弋	霍峻	父亲
萨姆-贝拉米	史蒂芬	父亲
刘胜	汉景帝刘启	父亲
王子发	王仕珠	父亲
赵庸	赵钦	父亲
谢婉莹	谢葆璋	父亲
爱新觉罗-慧生	爱新觉罗-溥杰	父亲
约翰·梅尔	理查	父亲
李殿朗	李翰祥	父亲
张芷芬	张如海	父亲
盘庚	祖丁	父亲
张彤	张中伟	父亲
江田五月	江田三郎	父亲
张孝若	张謇	父亲
许地山	许南英	父亲
琪琪	牛魔王	父亲
萧美人	萧铄	父亲
李泌	李承休	父亲
陈少霖	陈德霖	父亲
萧星华	萧克	父亲
拔都	术赤	父亲
徐仁	徐晋	父亲
徐学敏	徐匡迪	父亲
谭咏麟	谭晓风	父亲
黄万里	黄炎培	父亲
李少春	李宝春	父亲
细田博之	细田吉藏	父亲
张国强	张海峰	父亲
沈铁梅	沈福存	父亲
高连甲	高韵芬	父亲
路易·拿破仑·波拿巴	路易·波拿巴	父亲
孙楷	孙韶	父亲
喀喀木	塘阿礼	父亲
容安	那彦成	父亲
陈封怀	陈师曾	父亲
吕后	吕文	父亲
英武可汗	骨力裴罗	父亲
陈照旭	陈发科	父亲
丁水波	丁金朝	父亲
乐城公主	唐玄宗李隆基	父亲
完颜阿骨打	完颜劾里钵	父亲
爱新觉罗-弘昐	雍正皇帝	父亲
伍登	伍云召	父亲
徐莲娇	徐福元	父亲
孝庄文皇后	寨桑-布和	父亲
爱德华-埃弗里特	奥利佛-埃弗里特	父亲
倪震	倪匡	父亲
姜恪	姜宝谊	父亲
高盛麟	高庆奎	父亲
马尔蒂-阿赫蒂萨里	奥伊瓦	父亲
刘体智	刘秉璋	父亲
郭知章	郭福道	父亲
尔冬升	尔光	父亲
辜成允	辜振甫	父亲
祝钒刚	祝雪麟	父亲
葛小宝	葛香亭	父亲
孙希民	孙宪法	父亲
独孤贵妃	独孤颖	父亲
王仁东	王立才	父亲
马超	马腾	父亲
乔治-奥巴马	巴拉克-侯赛因-奥巴马一世	父亲
黄志鹏	黄秀明	父亲
李杭	李苦禅	父亲
福康安	傅恒	父亲
李连杰	李清泉	父亲
周信芳	周慰堂	父亲
马晓云	马志国	父亲
姜大卫	严化	父亲
布兰登·费雪	彼得·弗雷泽	父亲
刘锡荣	刘英	父亲
段祺瑞	段从德	父亲
杨为民	杨秀峰	父亲
奥利维亚-巴勒莫	Douglas Palermo	父亲
张陈鹏	张仁宾	父亲
张重华	张骏	父亲
上海妹	太子友	父亲
费德里克·马切达	帕斯夸莱·马切达	父亲
王琳	王跃平	父亲
李元霸	李渊	父亲
圣婴大王	牛魔王	父亲
雷声	雷献民	父亲
玛丽-拖德	罗伯特-拖德	父亲
顾传玠	顾瑞卿	父亲
刘墉	刘统勋	父亲
刘妃	刘懋	父亲
萧纲	梁武帝	父亲
杜淳	杜志国	父亲
罗尼·图里亚夫	塞萨尔	父亲
阳石公主	刘彻	父亲
汉代才女	卓王孙	父亲
森长可	森可成	父亲
关颖	陈国和	父亲
文嘉	文徵明	父亲
冯子和	冯三喜	父亲
姬贵	周灵王	父亲
杨桂玲	杨爱军	父亲
乔致庸	乔全美	父亲
陈国峻	陈柳将	父亲
薛涛	薛郧	父亲
文姜	齐僖公	父亲
弗洛里	约瑟夫-弗洛里	父亲
周亚特	周书楷	父亲
阿隆索	里查德	父亲
张子健	张志宽	父亲
刘据	汉武帝	父亲
陈后主	陈顼嫡	父亲
李如松	李成梁	父亲
劳拉·布什	哈罗德·维尔奇	父亲
神威	星海坊主	父亲
天野隆重	天野元行	父亲
威廉王子	查尔斯王储	父亲
王子涵	王晶	父亲
培根	尼古拉	父亲
马科·贾里奇	斯莱克·贾里奇	父亲
朱松	朱森	父亲
安娜-阿尼西莫娃	瓦西里-阿尼西莫夫	父亲
刘耀梅	刘荣榜	父亲
鲍蕙荞	鲍国宝	父亲
布鲁诺-阿尔维斯	华盛顿-阿尔维斯	父亲
梁必业	梁兴教	父亲
钱瑗	钱钟书	父亲
野原新之助	野原广志	父亲
赵弘殷	赵敬	父亲
陈姗姗	陈毅	父亲
乔纳森	约翰-莫里斯	父亲
白士林	白玉珍	父亲
赵均	赵宧光	父亲
江绵康	江泽民	父亲
欧仁·德拉克罗瓦	C德拉克洛瓦	父亲
严复	严正先	父亲
马蒂亚·瓦洛蒂	阿德里亚诺·瓦洛蒂	父亲
王则柯	王季思	父亲
管虎	管宗祥	父亲
琼-巴里	尼克-巴里	父亲
肖俊超	肖遂志	父亲
孙振泉	孙甫亭	父亲
张骏	张寔	父亲
赵光美	赵弘殷	父亲
王洛宾	王德祯	父亲
刘思雨	李柏寿	父亲
杨健侯	杨露蝉	父亲
陈景元	陈正擢	父亲
田嘉伟	田祖德	父亲
格雷格-奥登	Greg Sr	父亲
蒋孝严	蒋经国	父亲
刘恕	刘涣	父亲
迈克-佩勒姆	彼得-佩勒姆	父亲
马提亚·马提斯提尼	卡瓦列雷路易吉·马提斯提尼	父亲
李国平	李省三	父亲
本-拉登	穆罕默德-本-拉登	父亲
长宁公主	唐中宗	父亲
叶选廉	叶剑英	父亲
许援朝	开国上将许世友	父亲
武才人	武士彠	父亲
蔡尔兹	韦恩	父亲
杰米·戴蒙	西奥多Theodore	父亲
李盟盟	李国新	父亲
耿继茂	耿仲明	父亲
居斯塔夫-莫罗	路易-让-玛丽-莫罗	父亲
诸葛瑾	诸葛圭	父亲
卡梅伦	伊恩-卡梅伦	父亲
霍思纬	霍震寰	父亲
交河公主	阿史那怀道	父亲
董维孝	董孝清	父亲
爱新觉罗-福沛	雍正皇帝	父亲
刘鸥	刘洪波	父亲
郝京妮	郝建国	父亲
南康公主	司马绍	父亲
葛彤	葛绥之	父亲
关心焉	关元昌	父亲
张方林	张吉根	父亲
柳亚子	柳念曾	父亲
阿里埃勒·沙龙	沙廖尔	父亲
十时连贞	十时惟次	父亲
王魁武	王振元	父亲
许建彤	许晋亨	父亲
耿聚忠	耿继茂	父亲
林璎	林恒	父亲
尼尔-阿姆斯特朗	斯蒂芬-科尼-阿姆斯特朗	父亲
岳锺琪	岳升龙	父亲
刘奔	原谨吾	父亲
南希-佩洛西	汤米-亚利桑德罗	父亲
邢嘉倩	邢李源	父亲
刘源	刘少奇	父亲
尚长荣	尚小云	父亲
冯洪志	冯玉祥	父亲
灵怀王皇后	王章	父亲
熊毅	熊继成	父亲
林森	林道炳	父亲
刘彻	刘启	父亲
郭炳湘	郭得胜	父亲
义阳公主	拓跋宏	父亲
爱新觉罗·弘时	爱新觉罗·胤禛	父亲
孙熙	孙瑜	父亲
刘鸿翱	刘济川	父亲
朱有煽	朱橚	父亲
苏我赤兄	苏我仓麻吕	父亲
路易斯-加瑞尔	菲利普-加瑞尔	父亲
成安公主	唐中宗李显	父亲
爱新觉罗-弘昐	爱新觉罗-胤禛	父亲
赵渭忠	赵山海	父亲
秦九韶	秦季槱	父亲
英宁	英若识	父亲
明仁宗	明成祖	父亲
庾澄庆	庾家麟	父亲
爱新觉罗-满达海	爱新觉罗-代善	父亲
韩庄子	韩简子	父亲
张克群	张维	父亲
郑献公	郑定公	父亲
孙亮	孙权	父亲
王淑媛	王隆夫	父亲
阿比盖尔·约翰逊	爱德华·约翰逊	父亲
言少朋	言菊朋	父亲
白土三平	冈本唐贵	父亲
罗瑞康	罗鹰石	父亲
夏美珍	松雪芳	父亲
秦羽	秦德	父亲
文世光	文从昌	父亲
塞琳娜-戈麦斯	Ricardo Gomez 　	父亲
董笑笑	董浩	父亲
索菲亚·科波拉	弗朗西斯·福特·科波拉	父亲
马丁·斯科塞西	露西奥诺·查尔斯·斯科赛斯	父亲
杨善深	杨凤书	父亲
陈燮阳	陈蝶衣	父亲
初代目火影	千手佛间	父亲
孙雅薇	孙德平	父亲
汉平帝	刘兴	父亲
陈本	陈矫	父亲
陈知建	陈赓	父亲
斛律光	斛律金	父亲
宋汶岩	宋学涛	父亲
格温妮斯·帕特洛	布鲁·帕特洛	父亲
徐东香	徐木根	父亲
侣箫	侣海岩	父亲
查理·罗贝尔	查理·德·安茹	父亲
杨奇	杨统	父亲
王静康	王恩明	父亲
池田温	池田古日	父亲
穆凯什·阿姆巴尼	迪鲁拜·阿姆巴尼	父亲
田起山	田士杰	父亲
张鹏飞	张贤瑞	父亲
克里斯蒂娜-费尔南德斯-德基什内尔	埃杜阿尔多-费尔南德斯	父亲
邓学贤	邓肖禹	父亲
阳骛	阳耽	父亲
吴大揆	吴公仪	父亲
赵芸蕾	赵立军	父亲
亚历山德拉-科斯坚纽克	康斯坦丁-科斯坚纽克	父亲
郑知同	郑珍	父亲
陈景润	陈元俊	父亲
陈衡哲	陈韬	父亲
曹整	曹操	父亲
伊逊	音达户齐	父亲
威灵顿公爵	莫宁顿伯爵	父亲
前少帝	刘盈	父亲
罗苹-莱特-潘	弗雷迪-盖儿-怀特	父亲
吕乂	吕常	父亲
张瑞云	张多福	父亲
威斯利-斯内德	巴里斯内德	父亲
艾伦·狄珍妮	艾略特	父亲
善化公主	朱祐杬	父亲
劳远昌	劳启祥	父亲
武敦儒	武三通	父亲
西泽润一	西澤恭助	父亲
朱守谦	朱文正	父亲
金正银	金正日	父亲
裘芸	裘盛戎	父亲
杨成武	杨殿华	父亲
刘建勋	刘贲予	父亲
汪静宜	汪友诚	父亲
李汴	曹东扶	父亲
王廷赞	王永禄	父亲
刘小楼	刘宝山	父亲
沈括	沈周	父亲
约翰·皮尔蓬·摩根	朱尼厄斯·斯潘塞·摩根	父亲
包玉刚	包兆龙	父亲
费贞绫	张舞曦	父亲
吴日正	吴振宇	父亲
丹巴林	比克大魔王	父亲
林庚	林宰平	父亲
福雷·纳辛贝	纳辛贝·埃亚德马	父亲
拔都可汗	术赤	父亲
李庆容	李辅	父亲
田永庚	田春明	父亲
郑克塽	郑经	父亲
菲利普王子	卡尔十六世-古斯塔夫	父亲
甄妃	甄逸	父亲
安藤守就	安藤守利	父亲
谢尔盖-布林	迈克尔	父亲
孙甫亭	孙怡云	父亲
杨应龙	杨烈	父亲
王礼锡	王肇均	父亲
卡马	卡马三世	父亲
米格尔-维罗索	安东尼奥-维罗索曾	父亲
大宝寺义氏	大宝寺义增	父亲
拓跋宏	拓跋弘	父亲
卫宣公	卫庄公	父亲
李艺	李书福	父亲
马处女	马振华	父亲
宋子文	宋嘉树	父亲
密雪儿·布兰奇	david	父亲
弗列得利克·肖邦	尼古拉·肖邦	父亲
胡秋原	胡康民	父亲
玛莎-路易丝公主	哈拉尔	父亲
佟文	佟锦成	父亲
谭毓仑	谭光耀	父亲
拉蒂兹	巴达克	父亲
王国鹏	王立家	父亲
兰陵公主	隋文帝杨坚	父亲
周兆明	周赐	父亲
金吒	托塔李天王	父亲
帕斯捷尔纳克	列昂尼德	父亲
李班	李荡	父亲
王艳兵	王青山	父亲
涂海波	涂序生	父亲
李志民	李庆文	父亲
于文凤	于镜波	父亲
乔治-赫伯特-沃克-布什	普雷斯科特-布什	父亲
吴华静	吴文瑞	父亲
蒋雯娟	蒋培基	父亲
麦格尼-铜须	玛多兰-铜须	父亲
皮埃尔·保罗·普吕东	克里斯托夫·普吕东	父亲
邵美成	邵志刚	父亲
彭云	彭咏梧	父亲
姚佩秋	姚席珍	父亲
刘外	刘买	父亲
富兰克林	乔赛亚-富兰克林	父亲
威廉-赫歇尔	艾萨克	父亲
项小米	项南	父亲
高长恭	高澄	父亲
薛钜夫	薛培基	父亲
朱能	朱亮	父亲
周国良	周怀民	父亲
陈品亨	陈鸿烈	父亲
肖恩-墨菲	托尼-墨菲	父亲
杜什科	阿纳托列-杜什科	父亲
连胜文	连战	父亲
李彝昌	李仁祐	父亲
陈军团	陈世通	父亲
林妙可	林晖	父亲
懿安皇后	郭暧	父亲
竹胁无我	竹胁昌作	父亲
爱新觉罗·满达海	爱新觉罗·代善	父亲
尼古拉斯·凯奇	奥古斯特·科波拉	父亲
何怡贞	何澄	父亲
谢婷婷	谢贤	父亲
蒋友松	蒋孝武	父亲
沈诗钧	沈振雄	父亲
李应元	李九成	父亲
朱有炥	朱橚	父亲
切斯特·艾伦·阿瑟	威廉·亚瑟	父亲
张荣时	张镇坤	父亲
车杜里	车范根	父亲
方慈	方之航	父亲
金圣权	金铁霖	父亲
蔡康永	蔡天铎	父亲
金韩松	金正男	父亲
唐老鸭	夸克莫尔-达克	父亲
拉克萨斯-朵勒阿	伊万-朵勒阿	父亲
马善双	马良辰	父亲
李长城	李泽文	父亲
努尔哈赤	爱新觉罗-塔克世	父亲
岸惠子	岸操	父亲
司马进	司马防	父亲
李大海	李成儒	父亲
景海鹏	景靠喜	父亲
慕容儁	慕容皝	父亲
叶选平	叶剑英	父亲
韩贞子	韩宣子	父亲
沈文季	沈庆之	父亲
坦维尔-布拉尔	阿维塔-布拉尔	父亲
丰臣秀胜	三好吉房	父亲
殷琰	殷道鸾	父亲
川島芳子	善耆	父亲
林家川	林和平	父亲
三岛由纪夫	平冈梓	父亲
李安琦	李小平	父亲
李京龙	李春江	父亲
席代瑨	席世鋆	父亲
王怀卿	王蕙芳	父亲
李幼蒸	李蒸	父亲
傅幸文	傅骏	父亲
刘亦婷	刘卫华	父亲
琼·巴里	尼克·巴里	父亲
郑祺龙	郑武	父亲
布莱克-莱夫利	Ernie Lively	父亲
乔治·奥巴马	巴拉克·侯赛因·奥巴马一世	父亲
沙奎尔-奥尼尔	Joseph Toney	父亲
小王彬彬	王彬彬	父亲
朱胤杲	朱勋瀼	父亲
文昭甄皇后	甄逸	父亲
何泽慧	何澄	父亲
耿雨春	耿鸣义	父亲
吴欢	吴祖光	父亲
米莉·塞勒斯	比利·雷·塞勒斯	父亲
尚芝蓉	尚云祥	父亲
苏誉	苏珩	父亲
赵德芳	赵匡胤	父亲
淑嘉皇贵妃	金三宝	父亲
刘敬宣	刘牢之	父亲
杨兰	杨阜	父亲
默多克	基思·默多克	父亲
弗里德里希·威廉·尼采	卡尔·路德维希	父亲
柳德米拉·普京娜	亚历山大·A·什克列布涅夫	父亲
刘元珍	刘升	父亲
王世荷	王传淞	父亲
查尔斯-菲利浦-亚瑟-乔治-蒙巴顿-温莎	菲利普亲王	父亲
佐佐成政	佐佐成宗	父亲
许光	许世友	父亲
资中筠	资耀华	父亲
王永庆	王长庚	父亲
山本武	山本刚	父亲
张晋	张桂庭	父亲
沐剑声	沐天波	父亲
苏尔发	多尔博	父亲
腓特烈二世	腓特烈·威廉一世	父亲
徐志远	徐逸成	父亲
哈维-阿隆索	佩里克-阿隆索	父亲
黎鳌	黎溥棠	父亲
王永昌	王恩普	父亲
利铭泽	利希慎	父亲
李龙吟	李默然	父亲
许国祯	许日严	父亲
关银屏	关羽	父亲
胡充华	胡国珍	父亲
东宫铁男	东宫吉圣	父亲
刘冕	刘浚	父亲
丽贝卡-米勒	亚瑟??米勒	父亲
曹共公	曹班	父亲
李安娜	李月久	父亲
查尔斯王储	菲利普亲王	父亲
关曼青	关以文	父亲
Marie Trintignan	让·路易斯·特兰蒂尼昂	父亲
王力德	王大中	父亲
谢僧韶	谢尚	父亲
马彦祥	马衡	父亲
陈嘉言	陈虎臣	父亲
钟懿	钟镇涛	父亲
翟小兴	翟俊杰	父亲
刘建军	刘文瑞	父亲
斡儿答	术赤	父亲
刘荣	刘启	父亲
秦宣公	秦德公	父亲
志费尼	巴哈丁	父亲
丁震春	丁光荣	父亲
廖晓乔	廖伟志	父亲
骆晓娟	骆爱军	父亲
耶律璟	辽太宗	父亲
王怀治	王晓帆	父亲
倪嗣冲	倪淑	父亲
吉鸿昌	吉筠亭	父亲
陈尊佑	陈坤	父亲
王国平	王平夷	父亲
洪晃	洪君彦	父亲
凯特·温斯莱特	罗杰·温斯莱特	父亲
马提亚-马提斯提尼	卡瓦列雷路易吉-马提斯提尼	父亲
朱翊钧	朱载垕	父亲
约翰·基	乔治·基	父亲
爱新觉罗-弘晖	雍正皇帝	父亲
李冬梅	李国章	父亲
程万琦	程志行	父亲
格洛丽亚·马卡帕加尔·阿罗约	迪奥斯达多·马卡帕加尔	父亲
成龙	吴卓林	父亲
娄昭君	司徒内干	父亲
黄侃	黄云鹄	父亲
刘子鸾	刘骏	父亲
刘乔	刘阜	父亲
孙玉秀	孙国安	父亲
李学鹏	李锡财	父亲
李云迪	李川	父亲
苏玉玲	苏永伟	父亲
余胜荪	余紫云	父亲
马增芬	马连登	父亲
宋光华	宋铁麟	父亲
最上义光	最上义守	父亲
邓恩铭	邓国琮	父亲
杨仁山	朴庵公	父亲
蒲宜君	蒲浩明	父亲
阿尔贝·施韦泽	易斯	父亲
俞继康	俞俊华	父亲
帕丽斯-希尔顿	理查德-希尔顿	父亲
岐阳庄淑公主	唐宪宗李纯	父亲
谭文婉	谭从道	父亲
张韶轩	张志宏	父亲
波西	波塞冬	父亲
萧娴	萧铁珊	父亲
刘一坤	刘玉光	父亲
李新兰	李万春	父亲
杨广	杨坚	父亲
李存勗	李克用	父亲
胡蓉蓉	胡小元	父亲
张德江	张志毅	父亲
蒋明晋	蒋光业	父亲
聂小媛	聂乐春	父亲
杜美如	杜月笙	父亲
刘歆	刘向	父亲
独孤后	独孤信	父亲
安赫尔-迪马里亚	Miguel	父亲
甄家平	傅声	父亲
苏完瓜尔佳·幼兰	荣禄	父亲
聂人王	聂风	父亲
李雪艳	李伏坤	父亲
张二鹏	盖叫天	父亲
鲁思·本尼迪克特	佛雷迪·富尔顿	父亲
加藤高明	藩士服部重文之	父亲
刘芸杉	刘亚津	父亲
爱新觉罗-弘昼	雍正皇帝	父亲
赵宏博	赵玉民	父亲
梁漱溟	梁济	父亲
程多多	程十发	父亲
颜师古	颜思鲁	父亲
杜金莲	杜天鹏	父亲
吉安娜-玛利亚-奥诺尔-布莱恩特	科比-布莱恩特	父亲
薛仁贵	薛轨	父亲
玛吉-吉伦哈尔	斯蒂芬-吉伦哈尔	父亲
姚名达	姚芳权	父亲
叶至善	叶圣陶	父亲
沈之问	沈艾轩	父亲
赵四	赵庆华	父亲
吕振羽	吕平	父亲
安德雷-莫尔甘-拉米-阿尤	阿贝迪-贝利	父亲
傅敏	傅雷	父亲
刘嘉玲	刘桂明	父亲
袁行云	袁励准	父亲
项崇周	项正清	父亲
司马柬	司马炎	父亲
靳万春	靳国瑞	父亲
姚佩兰	姚席珍	父亲
辽太宗	耶律阿保机	父亲
曹操	安阳公主	父亲
孙庆龄	宋教仁	父亲
丘福灿	丘西金	父亲
木村重成	木村重兹	父亲
马文聪	马子光	父亲
吕彤羽	吕正操	父亲
王国强	王锦辉	父亲
肖策能	肖劲光	父亲
王黎明	王炳南	父亲
杜奎三	杜凤元	父亲
徐宝宝	徐定金	父亲
金芝公主	方腊	父亲
李亘	李雪健	父亲
姜锡	金学俊	父亲
朱定	朱誉荣	父亲
瓦尔纳·冯·布伦堡	艾米尔-冯-布伦堡	父亲
施少明	施鸣光	父亲
顾慰连	顾毓琇	父亲
马克斯·德尔布吕克	汉斯·德尔布吕克	父亲
蚁美厚	蚁仲居	父亲
侯少奎	侯永奎	父亲
戈宝权	戈曙东	父亲
曹操之女	曹孟德	父亲
冯赟	冯璋	父亲
薛涛	薛郧	父亲
李超	李奘图	父亲
曹景行	曹聚仁	父亲
李振祜	李长森	父亲
孔令侃	孔祥熙	父亲
陈自强	陈小星	父亲
陈自强	陈小兴	父亲
周小周	周衣冰	父亲
何姿	何常泰	父亲
尼古拉一世	保罗一世	父亲
杨少彭	杨乃彭	父亲
钱穆	钱承沛	父亲
袁振威	袁小田	父亲
徐昭佩	徐琨	父亲
叶楚伧	叶凤巢	父亲
卫长公主	汉武帝刘彻	父亲
耿昭忠	耿继茂	父亲
英小乐	英若诚	父亲
哈元章	哈宝泉	父亲
舒明天皇	押坂彦人大兄皇子	父亲
晶尼堪	苏宁阿	父亲
德尔-波特罗	丹尼尔-德尔波特罗	父亲
花鬘	孟获	父亲
博登斯基	赫尔伯特-博登斯基	父亲
陈赓	陈绍纯	父亲
和硕怀恪公主	爱新觉罗·胤禛	父亲
英若识	英千里	父亲
穆斯塔法-凯末尔	阿里-里札	父亲
樊浩霖	樊子云	父亲
郑东汉	郑中基	父亲
黄飞鸿	黄麒英	父亲
卡洛斯-斯利姆-埃卢	朱立安-斯利姆-海达第	父亲
何彬	何尚清	父亲
沃伊切赫-什琴斯尼	马切伊-什琴斯尼	父亲
徐申如	徐星匏	父亲
张猛	张惠中	父亲
周启邦	周锡年	父亲
高阳公主	唐太宗	父亲
宋徽宗赵佶第二十女赵多富	宋徽宗	父亲
长冢圭史	长冢京三	父亲
史蒂夫-戴维斯	比尔-戴维斯	父亲
赵会	赵永发	父亲
陈位林	陈维精	父亲
艾米-雷德福	罗伯特-雷德福	父亲
徐湛之	徐逵之	父亲
冯让先	冯超然	父亲
方召麐	方寿额	父亲
李敏	毛泽东	父亲
邢锐	邢天恩	父亲
石评梅	石铭	父亲
汪静	汪道涵	父亲
寿昌公主	唐睿宗李旦	父亲
肖恩-赫本-费雷	Mel	父亲
连咏心	连战	父亲
江林晏	江德富	父亲
阿术	兀良合台	父亲
金津	金良顺	父亲
赵钦	赵庸	父亲
章亚若	章贡涛	父亲
李德裕	李吉甫	父亲
瑞贝卡·布莱克	约翰·布莱克	父亲
王子平	王福宏	父亲
加藤清正	加藤清忠	父亲
王华	王守仁	父亲
穆里玛	卫齐	父亲
徐訏	徐荷君	父亲
黄淮	黄性	父亲
张闾瑛	张学良	父亲
黛安娜王妃	爱德华·约翰	父亲
马晓天	马载尧	父亲
李焕之	李孙修	父亲
陈泰	陈群	父亲
孔令贻	孔祥珂	父亲
陈楠	陈进平	父亲
詹姆斯二世	查理一世	父亲
道格拉斯-霍姆爵士	邓格拉斯勋爵	父亲
郤诜	郤晞	父亲
王新欣	王克	父亲
朱孟爚	朱桢	父亲
刘邦	刘太公	父亲
高朴	高恒	父亲
埃尔热	Alexis	父亲
何剑锋	何享健	父亲
恭哀皇后许氏	许广汉	父亲
王金声	王锡庆	父亲
湖阳公主	刘钦	父亲
尼科罗-帕格尼尼	安东尼欧-帕格尼尼	父亲
乔纳森利特尔	罗伯特-利特尔	父亲
杨受成	杨成	父亲
李宛妲	马悠	父亲
李由	李斯	父亲
宋德亮	宋明成	父亲
诸葛珪	诸葛瑾	父亲
阿曼达-塞弗里德	杰克-塞弗里德	父亲
巴切莱特	阿尔贝托-巴切莱特	父亲
丁惟汾	丁以此	父亲
明孝宗朱祐樘和张皇后之女朱秀荣	明孝宗朱祐樘	父亲
孙志浩	孙文麒	父亲
郭长江	郭沫若	父亲
孙明经	孙熹圣	父亲
克劳迪奥-阿劳	卡洛斯-阿劳	父亲
庞伟	庞彦宏	父亲
茅于轼	茅以新	父亲
贝吉塔	贝吉塔王	父亲
王海容	王德恒	父亲
姬猛	周景王	父亲
王世强	王经春	父亲
顾城	顾工	父亲
阳石公主	汉武帝	父亲
比栗	婆闰	父亲
裴光庭	裴行俭	父亲
吴旻	吴贻荪	父亲
慕容顺	伏允	父亲
黄天化	黄飞虎	父亲
凯瑟琳	约翰-肖达	父亲
玛格丽特·杜鲁门·丹尼尔	哈里·S·杜鲁门	父亲
凯姆-吉甘戴	Jay	父亲
罗纳德	罗纳尔多	父亲
吴湖帆	吴讷士	父亲
黄九龄	黄天霸	父亲
东阳公主	唐太宗	父亲
梁醒波	梁悦	父亲
达科塔·范宁	史帝夫·范宁	父亲
陈是知	陈可辛	父亲
黄元御	黄钟	父亲
朱宝元	朱坡	父亲
冯丹龙	冯洪达	父亲
刘英姿	刘耀武	父亲
查尔斯-马丁-霍尔	赫曼-巴赛特-霍尔	父亲
劳埃德·本特森	劳埃德·米拉德·老·本特森	父亲
文强	文明君	父亲
李惠堂	李浩如	父亲
哈罗德-麦克米伦	莫里斯??克劳福德??麦克米伦	父亲
朱桔榕	朱孟依	父亲
王敏清	王世英	父亲
姜威	姜伟	父亲
杨昭	杨广	父亲
阿尔忒弥斯	宙斯	父亲
汪曰桢	汪延泽	父亲
林大八	林秀芳	父亲
霍启山	霍震霆	父亲
关楚耀	关维麟	父亲
马德莱娜	卡尔十六世-古斯塔夫	父亲
吴公仪	吴鉴泉	父亲
司马德宗	晋孝武帝	父亲
楚熊狂	楚熊丽	父亲
本笃十六世	老若瑟·拉辛格	父亲
元孟蕤	元怿	父亲
唐太宗李世民第十九女兰陵公主	唐太宗李世民	父亲
小柴昌俊	小柴俊男	父亲
武迟	武曾传	父亲
尹长清	杜良奎	父亲
金津	金良顺	父亲
傅熹年	傅忠谟	父亲
伊秉绶	伊朝栋	父亲
李依琳	李德麟	父亲
周启邦	周锡年	父亲
陆俨少	陆韵伯	父亲
谢安	谢裒	父亲
陈叔宝	陈顼嫡	父亲
王晓星	王玉祥	父亲
丽顿-麦斯达	Doug Meester	父亲
宫野厚司	灰原哀	父亲
王大珩	王应伟	父亲
刘嫖	汉文帝刘恒	父亲
李旦旦	李应生	父亲
高国华	高逸鸿	父亲
徐小圃	杏圃公	父亲
任长霞	任占德	父亲
马延强	马惜如	父亲
恭镗	琦善	父亲
沈祖牟	沈觐平	父亲
梅根·麦凯恩	约翰·麦凯恩	父亲
瓦尔纳-冯-布伦堡	艾米尔-冯-布伦堡	父亲
马秀英	马二公	父亲
户泽盛安	户泽道盛	父亲
孔子	叔梁纥	父亲
谢家麟	谢良佐	父亲
钱宝莲	钱阿四	父亲
高德明	高闻元	父亲
周武王	姬昌	父亲
朱璟洗	朱朗鐀	父亲
许德义	许荫棠	父亲
朗-霍华德	琼-霍华德	父亲
陈晓林	陈先水	父亲
郑嘉琴	郑传鉴	父亲
刘隗	刘砥	父亲
苏若兰	苏道质	父亲
慕容暐	慕容儁	父亲
和硕和嘉公主	爱新觉罗·弘历	父亲
慕容德	慕容皝	父亲
迈克尔-乔丹	詹姆斯-乔丹	父亲
黄远	黄仲昆	父亲
杨铁虎	杨盛春	父亲
大流士一世	希斯塔斯帕	父亲
孙尚香	孙坚	父亲
淮南公主	唐高祖李渊	父亲
徐伯阳	徐悲鸿	父亲
李小璐	李丹宁	父亲
上衫谦信	长尾为景	父亲
赫拉克勒斯	宙斯	父亲
周鸣江	周耀庭	父亲
托勒密二世	托勒密一世	父亲
徐承煜	徐桐	父亲
卫长公主	刘彻	父亲
舒适	舒石父	父亲
李白	李客	父亲
傅全香	孙琴文	父亲
程高	琼布多杰	父亲
李俊锋	李富荣	父亲
习桥桥	习仲勋	父亲
薛钰	薛纮	父亲
李鹏	李硕勋	父亲
尹厚	尹民秀	父亲
托比-斯蒂芬斯	罗伯特-斯蒂芬斯	父亲
张国荣	张活海	父亲
明熹宗	明光宗	父亲
徐熙娣	徐坚	父亲
陈以真	陈镜尧	父亲
朱企令	朱干蛙	父亲
陆侃如	陆措宜	父亲
舒妃	纳兰永绶	父亲
晋恭帝之女	晋恭帝司马德文	父亲
米勒德·菲尔莫尔	撒尼尔·菲尔莫尔	父亲
释小松	李旭东	父亲
罗点点	罗瑞卿	父亲
关颖	陈国和	父亲
滕华弢	滕文骥	父亲
韩哀侯	韩文侯	父亲
杨政龙	杨受成	父亲
赵一楠	赵本山	父亲
莽哥不花	阿哈出	父亲
吴廷琛	吴文奎	父亲
赵元佐	宋太宗赵光义	父亲
万寿公主	唐宣宗李忱	父亲
黄三德	黄世尚	父亲
阳翟长公主	汉桓帝	父亲
上古帝王唐尧的长女	帝尧	父亲
华特·迪斯尼	伊利亚斯·迪士尼	父亲
李上金	唐高宗	父亲
章伯钧	章扬清	父亲
陈始昌	陈泽光	父亲
陈永安	陈龙	父亲
克里斯蒂安·马尔蒂尼	保罗·马尔蒂尼	父亲
罗伯特-潘兴-瓦德罗	Harold	父亲
殷洪	帝辛	父亲
陈丽芳	陈福胜	父亲
范扬	范临	父亲
马塞尔·普鲁斯特	阿德里安·普鲁斯特	父亲
杨贤江	杨树芳	父亲
图坦卡蒙	阿肯那顿	父亲
黄一山	黄一飞	父亲
贺黎明	贺龙	父亲
安东尼奥·维瓦尔第	乔瓦尼·巴蒂斯塔·维瓦尔第	父亲
于谦	于德纲	父亲
叶光	叶蓬	父亲
王泳泉	王岐山	父亲
廖汉生	廖兰湘	父亲
刘綎	刘显	父亲
孛儿只斤·那木罕	孛儿只斤·忽必烈	父亲
唐庆增	唐文治	父亲
周向红	周宇驰	父亲
夏亚	吉恩-什姆-戴肯	父亲
曹节	曹操	父亲
王玉龄	王树南	父亲
玛丽亚-埃莉奥诺拉	约翰-西格斯	父亲
尚慧敏	尚长春	父亲
孙泱	孙炳文	父亲
周天	周云亮	父亲
周尔璧	周楫浦	父亲
吴宗恩	吴光正	父亲
宋宝罗	宋永珍	父亲
小早川秀秋	木下家定	父亲
刘贺	昌邑哀王刘髆	父亲
卡特琳娜-格兰厄姆	Joseph Graham	父亲
蒙奇·D·路飞	蒙奇·D·龙	父亲
黄薇	黄德嘉	父亲
张议潮	张千一	父亲
陈冠希	陈泽民	父亲
柳超	柳春栋	父亲
李仕凡	李华得	父亲
吉米-莱科宁	马蒂-莱科宁	父亲
张大中	张以成	父亲
贾兰	贾珠	父亲
庄静固伦公主	嘉庆帝	父亲
王子英	王茂斋	父亲
孙连仲	孙保安	父亲
李忠	唐高宗	父亲
潘阳	潘长江	父亲
张申府	张濂	父亲
曾小东	曾希圣	父亲
傅抱石	傅得贵	父亲
瓦尔特-施伦堡	Guid	父亲
宋国祥	宋永发	父亲
哈利-S-杜鲁门	约翰-安德森-杜鲁门	父亲
康盘石	康敦煜	父亲
鲁隐公	鲁惠公	父亲
陈铭枢	陈均镕	父亲
渊盖苏文	渊太祚	父亲
萧绎	萧衍	父亲
梁思庄	梁启超	父亲
徐玄冲	徐曾旺	父亲
王昌彪	王乃水	父亲
袁信义	袁小田	父亲
袁牧女	袁牧之	父亲
陈群	陈纪	父亲
严庆祥	严裕棠	父亲
乔治·西蒙·欧姆	乔安·渥夫甘·欧姆	父亲
迈克尔-舒马赫	罗尔夫-舒马赫	父亲
刘瑾	刘沆	父亲
爱新觉罗-载淳	爱新觉罗-奕詝	父亲
裴永杰	裴少春	父亲
陆宏	陆瑞华	父亲
威理博-斯涅尔	鲁道夫-斯涅尔	父亲
郑梦准	郑周永	父亲
卜祚光	卜宁一	父亲
朱定燑	朱誉荣	父亲
刘炽	刘彭卿	父亲
舟木一夫	上田荣吉	父亲
陈冠希	陈泽民	父亲
朱定灮	朱誉荣	父亲
赵幽缪王	赵悼襄王	父亲
罗莎里奥·弗洛雷斯	安东尼奥·冈萨雷斯	父亲
艾米莉-莫迪默	约翰-莫迪默	父亲
一休宗纯	后小松天皇	父亲
孙伯文	孙汉章	父亲
谭晓光	谭震林	父亲
郑桓公	周厉王	父亲
丰绅殷德	钮祜禄-和珅	父亲
陆皓东	陆晓帆	父亲
洪博培	乔恩·M·亨茨曼	父亲
钱浩梁	钱麟童	父亲
肖佳玉	肖四北	父亲
马场信房	教来石远江守信保	父亲
陈中	陈新生	父亲
毛泽建	毛尉生	父亲
卡卡	鲍斯高·伊泽森·柏莱拉·莱特	父亲
比尔-盖茨	William H  Gates	父亲
宋振中	宋绮云	父亲
陆涛	徐志森	父亲
陈冰	陈永生	父亲
孙元坡	孙毓堃	父亲
真田幸村	真田昌幸	父亲
刘继卣	刘奎龄	父亲
周波	周新国	父亲
李有祯	李福泽	父亲
乔金·诺阿	雅尼克·诺阿	父亲
夏侯霸	夏侯渊	父亲
白星	尼普顿	父亲
马克思	亨利希	父亲
宗泽	宗舜卿	父亲
萧远山	萧峰	父亲
亚伯拉罕-林肯	托马斯-林肯	父亲
宣华夫人	陈顼	父亲
陈启源	陈敬芳	父亲
威廉一世	腓特烈-威廉三世	父亲
伍修权	伍理钊	父亲
麦理浩勋爵夫人	托马斯-查理斯-邓洛普爵士	父亲
儒家学派创始人	叔梁纥	父亲
靳万春	靳国瑞	父亲
伊莎贝尔二世	费尔南德七世	父亲
林语堂	林至诚	父亲
琳赛-罗翰	迈克尔-罗韩	父亲
朱盘烒	朱权	父亲
丁耀亢	丁惟宁	父亲
刘鹗	刘成忠	父亲
韦昭容	韦匡伯	父亲
毛新宇	毛岸青	父亲
黄家教	黄际遇	父亲
陈光中	陈躬农	父亲
顾凯之	顾悦之	父亲
赵春桂	赵占元	父亲
阮伟祥	阮水龙	父亲
盛爱颐	盛宣怀	父亲
王念孙	王安国	父亲
施光南	施复亮	父亲
克里斯蒂安-贝尔	大卫-贝尔	父亲
登利可汗	毗伽可汗	父亲
西竹一	西德二郎	父亲
陈燕鸣	陈迪松	父亲
巴陵公主	李世民	父亲
耿喜斌	耿永福	父亲
查尔斯·狄更斯	约翰·狄更斯	父亲
托尼·布莱尔	利奥·布莱尔	父亲
佐竹义重	佐竹义昭	父亲
格奥尔格-弗里德里希	普鲁士亲王小路易-斐迪南	父亲
谭正岩	谭孝曾	父亲
薛瑞鹏	薛永堂	父亲
秦小梅	秦力真	父亲
张杨	张华勋	父亲
李欧梵	李永刚	父亲
尹章旭	尹春保	父亲
约翰	亨利二世	父亲
梅竹芬	梅巧玲	父亲
孙云鹏	孙贤禄	父亲
吴涵碧	吴俊才	父亲
王馨平	王羽	父亲
洪天照	洪金宝	父亲
赵君玉	赵小廉	父亲
盛品儒	盛毓凤	父亲
曹雷	曹聚仁	父亲
文震孟	文元发	父亲
刘彩芹	刘起福	父亲
曹桂芬	曹东扶	父亲
崔神基	崔义玄	父亲
李存勖	李克用	父亲
陈淑文	陈瑞鸿	父亲
多尔济	明安	父亲
果安法师	张德利	父亲
申雪	申杰	父亲
张弘范	张柔	父亲
唐蔓莎	唐立朝	父亲
萧涤非	萧雪初	父亲
刘小英	刘英	父亲
拓跋晃	拓跋焘	父亲
蔡威廉	蔡元培	父亲
陈露	陈喜勤	父亲
田大畏	田汉	父亲
刘宠	刘丕	父亲
亨利·德·巴耶·拉图尔	费迪南德·德·巴耶·拉图尔伯爵	父亲
孙国雄	孙治平	父亲
蕾切儿-哈伍德	Philip Hurd Wood	父亲
宫市亮	宫市达	父亲
曹昂	曹操	父亲
余惠光	余文襄	父亲
何东	何仕文	父亲
罗兰	靳兰田	父亲
蔡碧吟	蔡国琳	父亲
伊雷	伊秋水	父亲
周柏年	周庆贤	父亲
达里安·莫格莱尼	亚历山德罗斯·莫格莱尼	父亲
闻立鹏	闻一多	父亲
元明月	元愉	父亲
李西华	李岩	父亲
黄远	黄仲昆	父亲
陈勇	陈坊仁	父亲
容妃	阿里和卓	父亲
梅则勇	梅尚白	父亲
鲁轨	鲁宗之	父亲
吴芝瑛	吴康之	父亲
姜泰俊	姜根宇	父亲
巴尔托洛梅乌-迪亚士	迪尼什-迪亚士	父亲
詹姆斯·艾伯拉姆·加菲尔德	艾布拉姆·加菲尔德	父亲
王以智	王国桐	父亲
宋步云	宋思伦	父亲
铫期	铫猛	父亲
黄子容	黄志昌	父亲
李兆麟	李介甫	父亲
阿隆索	里查德-高仕	父亲
傅彦	彭真	父亲
小道格拉斯·范朋克	道格拉斯·范朋克	父亲
武宫正树	武宫不二男	父亲
齐妃	李文辉	父亲
薄小莹	薄一波	父亲
乔治-凯西	老乔治-凯西	父亲
郭冬临	郭昌仪	父亲
司马曜	司马昱	父亲
刘终古	刘遗	父亲
陈炜	陈正湘	父亲
卞鼐	卞元九	父亲
卓文君	卓王孙	父亲
明宪宗	明英宗	父亲
吴敦义	吴奚	父亲
孙英杰	孙凤有	父亲
巴德尔甘-拜卡达莫娃	巴赫德让-拜卡达莫夫	父亲
朱征钤	朱范址	父亲
邓祖琳	邓定远	父亲
孙登	孙权	父亲
朱肱	朱临	父亲
李先念	李成元	父亲
奥黛丽-赫本	约瑟夫-维克特-安瑟尼-赫本	父亲
乔丹·阿尤	阿贝迪·贝利	父亲
释迦牟尼	净饭王	父亲
胡军	胡宝善	父亲
朱禋泞	朱誉荣	父亲
李湛	李义府	父亲
马蒂亚-瓦洛蒂	阿德里亚诺-瓦洛蒂	父亲
文俶	文从简	父亲
余嘉锡	余嵩庆	父亲
吕大临	吕蕡简	父亲
喻越越	喻志刚	父亲
顺治	皇太极	父亲
张茂	张曜灵	父亲
蒙奇-D-路飞	蒙奇-D-龙	父亲
浦熙修	浦友梧	父亲
唐太宗李世民第十一女清河公主	唐太宗李世民	父亲
林志刚	林孚昌	父亲
小早川隆景	毛利元就	父亲
李望知	薄熙来	父亲
汪兆炳	汪小亭	父亲
鲍勋	鲍信	父亲
劳埃德-米拉德-小-本特森	劳埃德-米拉德-老-本特森	父亲
郑羲	郑晔	父亲
陈蓓	陈斌	父亲
聂耳	聂鸿仪	父亲
阿山	阿尔塔什	父亲
孙眉	孙达成	父亲
丁俊晖	丁文钧	父亲
李嫣	李亚鹏	父亲
朱范址	朱冲秌	父亲
秦元勋	秦学仁	父亲
郝海东	郝文生	父亲
莎拉-洁西卡-帕克	史蒂芬-帕克	父亲
王亦兵	王耀轩	父亲
陈元方	陈寔	父亲
林室雅	林文山	父亲
刘家良	刘湛	父亲
晋陵公主	晋孝武帝	父亲
陈晓亮	陈先水	父亲
刘恕	刘涣	父亲
唐有壬	唐才常	父亲
陈正薇	陈大悲	父亲
杨康	杨铁心	父亲
刘骏	刘义隆	父亲
刘开瑾	刘生昌	父亲
凯瑟琳·帕尔	托马斯·帕尔爵士	父亲
赵萝蕤	赵紫宸	父亲
王家瑢	王乃斌	父亲
冯胜	冯文质	父亲
北条纲成	福岛正成	父亲
马远	马世荣	父亲
吴敏霞	吴钰明	父亲
张充和	张冀牖	父亲
魏宁	魏善斋	父亲
关学曾	关春伦	父亲
陈文琦	王永庆	父亲
铃木善幸	铃木善五郎	父亲
拓西可汗	阿史那默啜	父亲
林岱桦	林三郎	父亲
徐静斐	徐悲鸿	父亲
薛禹谷	薛明剑	父亲
俞大维	俞明颐	父亲
胡德平	胡耀邦	父亲
汪文恂	汪精卫	父亲
姜杰	姜春云	父亲
珀尔修斯	宙斯	父亲
林文堂	林佳	父亲
李淑	唐太宗李世民	父亲
李培香	李兴发	父亲
张剑青	筱文滨	父亲
林觉民	林孝颖	父亲
高湛	高欢	父亲
严世番	严嵩	父亲
刘延东	刘瑞龙	父亲
楚蚡冒	熊霄敖	父亲
秦共公	秦康公	父亲
坂田荣男	坂田荣七	父亲
孙权	孙坚	父亲
高晓松	高立人	父亲
朱维斌	朱湘泉	父亲
刘良	刘回	父亲
华阳公主	武穆皇帝元怀	父亲
克里斯蒂娜-阿奎莱拉	弗斯脱-瓦格纳-赛维尔-阿奎莱拉	父亲
迭戈·弗兰	巴勃罗·弗兰	父亲
乾隆皇帝	清世宗雍正帝	父亲
道格拉斯-麦克阿瑟	阿瑟-麦克阿瑟	父亲
朱家骅	云舫	父亲
卫长公主	汉武帝	父亲
傅尧笙	傅题寿	父亲
李磊	李卜春	父亲
朱见深	明英宗	父亲
昭庆公主	宋太祖	父亲
周采茨	周信芳	父亲
小约瑟夫-赫尔梅斯伯格	约瑟夫-赫尔梅斯伯格	父亲
许百遒	许甄	父亲
王雪红	王永庆	父亲
王安石	王益	父亲
定安亲王永璜	乾隆	父亲
周汤豪	周禹侯	父亲
王妮	王庆尧	父亲
陈胜福	陈明吉	父亲
蔡子安	蔡建波	父亲
李蓉芳	强云樵	父亲
汉光武帝	刘舆	父亲
奥利弗·克伦威尔	罗伯特·克伦威尔	父亲
邓以蛰	邓艺孙	父亲
宋司宇	宋铁军	父亲
钟丽燕	钟文奎	父亲
奥利维亚-芒恩	萨姆-玛恩	父亲
孝贤纯皇后	李荣保	父亲
守培法师	陈学贵	父亲
方曼生	方心诰	父亲
霍震宇	霍英东	父亲
吴缵姬	吴国华	父亲
宋锋	宋遇春	父亲
吴光磊	吴宗涵	父亲
张介冠	张锡龄	父亲
秦翼明	秦邦屏	父亲
华纯然	华弈天	父亲
杨少侯	杨健侯	父亲
苏泰	台吉德尔赫礼	父亲
吉默-弗雷德特	艾尔-弗雷迪特	父亲
梁思忠	梁启超	父亲
大门艺	大祚荣	父亲
桑托斯-迪蒙	亨里克-迪蒙	父亲
王文林	王长友	父亲
清河公主	晋惠帝	父亲
梁璧	梁赞	父亲
约翰·梅杰	汤姆·梅杰·波	父亲
蔡国庆	蔡仲秋	父亲
邓小平	邓文明	父亲
赵树屏	赵云卿	父亲
傅钰年	傅定谟	父亲
敦必乃	拜姓忽儿	父亲
丁立干	丁封	父亲
赵朴初	赵恩彤	父亲
韩桓惠王	韩厘王	父亲
塔姆塔姆	萨姆萨姆	父亲
盛钰琪	盛保华	父亲
朱徽焲	朱楩	父亲
贺兰敏之	贺兰安石	父亲
武惠妃	恒安王武攸止	父亲
冯毅之	冯绪臣	父亲
朴恩善	朴顺权	父亲
成烈嘉措	彭措才旺	父亲
曹圭贤	曹英华	父亲
樊棣生	樊永培	父亲
倪翠萍	倪恩金	父亲
叶明子	叶选廉	父亲
朱颖文	朱学智	父亲
李长治	李泽楷	父亲
山姆-休斯顿	塞缪尔-休斯顿	父亲
盖乌斯-屋大维	盖-屋大维乌斯	父亲
刘永行	刘大镛	父亲
孔德基	孔令杰	父亲
拉简-朗多	安波尔-朗多	父亲
孙科	孙中山	父亲
石抹也先	脱罗华察兒	父亲
德罗西	阿尔贝托-德罗西	父亲
彭寂宽	彭寿山	父亲
阎明光	阎宝航	父亲
燕红叶	燕赤霞	父亲
曹操	曹棘	父亲
戴维-卡梅伦	伊恩-唐纳德-卡梅伦	父亲
昔班	术赤	父亲
马增蕙	马连登	父亲
世铎	全龄	父亲
王统照	王秉慈	父亲
陶晴贤	陶兴房	父亲
金敬姬	金日成	父亲
杜甫	杜闲	父亲
唐丹	唐世叶	父亲
岸信介	岸秀助	父亲
阿莎	宗主	父亲
塔提亚娜-塔拉索娃	阿纳托利-塔拉索夫	父亲
皇后张氏	张去逸	父亲
陈执中	陈恕	父亲
王晓玉	王剑秋	父亲
王政君	王禁	父亲
科勒-卡戴珊	罗伯特-卡戴珊	父亲
李启铭	李刚	父亲
徐悲鸿	徐达章	父亲
刘牢之	刘建	父亲
安娜-索菲-皮柯	雅克-皮柯	父亲
黄诗怡	黄冠雄	父亲
夏侯武	夏侯勇	父亲
焦裕禄	焦方田	父亲
李宝春	李少春	父亲
张玉林	张德武	父亲
单联丽	单田芳	父亲
汤洛雯	汤镇宗	父亲
孝圣宪皇后	凌柱	父亲
孙休	孙权	父亲
李兴堂	李春长	父亲
约瑟夫·M·阿卡巴	拉尔夫·阿卡巴	父亲
尼格买提·热合曼	热合曼·马木提	父亲
薄瓜瓜	薄熙来	父亲
孙道存	孙法民	父亲
平都公主	汉元帝	父亲
朱由榔	朱常瀛	父亲
周少麟	周信芳	父亲
潘公凯	潘天寿	父亲
孙维世	孙炳文	父亲
韩寒	韩仁均	父亲
韩小野	韩寒	父亲
陈佳雨	陈维亚	父亲
劳伦斯	阿瑟-劳伦斯	父亲
慕容皝	慕容廆	父亲
邓海洋	邓加才	父亲
汤斌	汤契祖	父亲
果湘林	果福隆	父亲
李可燕	李旺平	父亲
贺兰祥	贺兰初真	父亲
金城公主	唐嗣雍王李守礼	父亲
李朋	李硕勋	父亲
阿卜杜拉	拉赫曼	父亲
珊农-露茜德	奥斯卡	父亲
后白河天皇	鸟羽天皇	父亲
孔冬梅	孔令华	父亲
王夫之	王朝聘	父亲
爱新觉罗-颙琰	爱新觉罗-弘历	父亲
小泉孝太郎	小泉纯一郎	父亲
何世柱	何耀光	父亲
朱之瑜	朱正	父亲
孙奋	孙权	父亲
爱德-韦斯推克	Peter Westwick	父亲
常宝庆	常连安	父亲
赵和春	赵砚奎	父亲
黄雪鹰	黄海瑞	父亲
七世达赖	索南达结	父亲
黄蓉	黄药师	父亲
朱瞻基	明仁宗	父亲
李小鹏	李鹏	父亲
潘长江	潘林生	父亲
吕玲绮	吕布	父亲
桑兰	桑史盛	父亲
西莱斯特·霍姆	霍姆	父亲
郭龄瑞	郭台强	父亲
陈幸妤	陈水扁	父亲
全惠解	全尚	父亲
王则楚	王季思	父亲
陈慧慧	陈廷骅	父亲
陈旭	陈彬	父亲
舒同	舒仁兴	父亲
桑德拉-伊兹巴沙	Florin Nicolae	父亲
盖乌斯·屋大维	盖·屋大维乌斯	父亲
石原慎太郎	石原莞尔	父亲
胡渊	胡烈	父亲
中森明菜	中森明男	父亲
李小环	李巴山	父亲
阿姆	Marshall Bruce Mathers Jr	父亲
萨载	萨哈岱	父亲
赵元任	赵衡年	父亲
冯安	冯和	父亲
吴元济	吴少阳	父亲
傅恒	李荣保	父亲
徐梗荣	徐和平	父亲
郭暧	郭子仪	父亲
莎拉-米歇尔-盖拉	Arthur Gellar	父亲
孝懿李皇后	德平伯李铭	父亲
黄国瑾	黄彭年	父亲
刘田依	刘觉民	父亲
章德窦皇后	窦勋	父亲
柴格	陈泽林	父亲
王怀见	王玉合	父亲
何爱榆	何甘棠	父亲
赵襄子	赵简子	父亲
韦妃	韦元珪	父亲
李正源	李亚力	父亲
吕海寰	吕晋险	父亲
傅书堂	傅炳勋	父亲
王丽萍	王凤栋	父亲
陈天逸	陈广畴	父亲
辜宽敏	辜显荣	父亲
薛万均	薛世雄	父亲
沈持衡	沈毅民	父亲
刘坤铭	刘思仁	父亲
遂安公主	唐太宗	父亲
张岱年	张濂	父亲
塞西尔-卡拉坦切娃	拉多斯拉夫-卡拉坦切夫	父亲
华蘅芳	华翼纶	父亲
王平	王宝春	父亲
张韶涵	张志宏	父亲
王采	王锡良	父亲
陈晓鲁	陈毅	父亲
邹桂芳	邹炳昌	父亲
独解支	比栗	父亲
乌尔夫·奥伊勒	汉斯·冯·奥伊勒·歇尔平	父亲
张嫣	张敖	父亲
谭俊彦	狄龙	父亲
爱新觉罗-弘昀	爱新觉罗-胤禛	父亲
李烈钧	李骏兴	父亲
朱朗鐀	朱谟墡	父亲
乔雨欣	乔天奇	父亲
黄良财	黄加得	父亲
田汉	田禹卿	父亲
杜凤元	杜奎三	父亲
阿灵阿	钮祜禄-遏必隆	父亲
杨松斯	阿维德-杨松斯	父亲
黄永年	黄兆熊	父亲
荣毅仁	荣德生	父亲
赵玉芳	赵本山	父亲
李万春	李永利	父亲
林海峰	林大奎	父亲
马清伟	马锦灿	父亲
鲁元公主	刘邦	父亲
朱塞佩·西格诺里	乔巴迪斯塔	父亲
颛顼	昌意	父亲
高志航	高景文	父亲
明仁	昭和天皇	父亲
郭宁莲	郭子兴	父亲
西格蒙德-弗洛伊德	Jacob	父亲
姚小明	姚明	父亲
张震	张国柱	父亲
唐韵笙	唐寿臣	父亲
朱有炯	朱橚	父亲
沈紫君	沈楚生	父亲
约翰·格雷·戈顿	约恩罗斯高登	父亲
李怿	朝鲜成宗	父亲
陈文新	陈昌	父亲
刘肇礼	刘文亚	父亲
门敢红	门惠丰	父亲
威廉三世	德皇威廉二世	父亲
吴铭	杨懋修	父亲
曹西平	曹培芳	父亲
王文洋	王永庆	父亲
马志明	马三立	父亲
刘景文	刘平	父亲
卢小玉	卢寿椿	父亲
李寿	李骧	父亲
人造恶魔果实	狐火锦卫门	父亲
黄磊 	黄小立	父亲
王雅捷	王和泉	父亲
段少舫	段荣华	父亲
史跃武	史民志	父亲
汪废后	汪瑛	父亲
史蒂芬-席格	史蒂芬	父亲
冯薇朵	冯小宁	父亲
安倍晋三	安倍晋太郎	父亲
谷政协	谷景生	父亲
爱新觉罗·福沛	爱新觉罗·胤禛	父亲
朱见深	朱祁镇	父亲
王亮	王洪礼	父亲
马德成	马泰玉	父亲
让-萨科齐	萨科奇	父亲
吴征	吴立岗	父亲
陈隆恪	陈三立	父亲
柿崎景家	柿崎利家	父亲
赖家林	赖鼎章	父亲
丽莎-玛丽-普雷斯利	埃尔维斯-普雷斯利	父亲
路易斯-雪佛兰	约瑟夫	父亲
王传蕖	王正廷	父亲
三毛	陈嗣庆	父亲
丁仪	丁冲	父亲
陈洁	陈玉春	父亲
刘航琛	刘子休	父亲
吴皇后	吴令珪	父亲
李传灿	李天禄	父亲
顺烈梁皇后	大将军梁商	父亲
刘亚洲	刘建德	父亲
王亮	王洪礼	父亲
王世强	王经春	父亲
顾秀林	顾准	父亲
燕王哙	燕易王	父亲
顾锡畴	顾天叙	父亲
玛塔·哈里	亚当·泽莱	父亲
魏斐徳	弗里德里克-魏克曼	父亲
王耀武	王进增	父亲
李少翔	李凤翔	父亲
陈济生	陈德蒲	父亲
慕容廆	慕容涉归	父亲
丁世方	丁维先	父亲
许建奎	许振祥	父亲
罗香林	罗幼山	父亲
中臣镰足	中臣御食子	父亲
杨玉儿	杨林	父亲
周以良	周明扬	父亲
孝平皇后	王莽	父亲
迪迪埃-德库安	亨利??德库安	父亲
燕哀侯	燕顷侯	父亲
李小双	李裕舟	父亲
郑多云	郑莲桂	父亲
刘晓江	刘海滨	父亲
汪键	汪顺清	父亲
郭荣启	郭瑞林	父亲
会稽公主	刘裕	父亲
阎世喜	阎岚秋	父亲
安倍昭惠	松崎昭雄	父亲
谭延闿	谭钟麟	父亲
塞塔里迪斯	迪米特里-塞塔里迪斯	父亲
马塞尔-普鲁斯特	阿德里安-普鲁斯特	父亲
遂平公主	明光宗朱常洛	父亲
后藤又兵卫基次	后藤基国	父亲
科尔沁夫	阿拉腾奥勒	父亲
伊辛巴耶娃	加里	父亲
张学思	张作霖	父亲
孔繁森	孔庆会	父亲
向健	向世富	父亲
周公	周文王	父亲
曾智雄	曾宪梓	父亲
瞿同祖	瞿宣治	父亲
王德辉	王廷歆	父亲
贾政	贾代善	父亲
奥利弗-威廉姆森	斯科特-威廉姆森	父亲
桑德罗-马佐拉	瓦伦蒂诺-马佐拉	父亲
后西天皇	后水尾天皇	父亲
周晓峰	周辞美	父亲
爱娃-格林	Walter Green	父亲
吴保初	吴长庆	父亲
辛夷	辛青山	父亲
纽璘	太答儿	父亲
向佐	向华强	父亲
长尾政景	长尾房长	父亲
吴梅	吴国榛	父亲
西姆-布拉尔	阿维塔-布拉尔	父亲
周今觉	周学海	父亲
耶律娄国	耶律倍	父亲
巩立姣	巩文全	父亲
陈小鲁	陈毅	父亲
徐熙媛	徐坚	父亲
卢承庆	卢赤松	父亲
欧阳娜娜	欧阳龙	父亲
王世襄	王继曾	父亲
孙钧卿	孙岳	父亲
何厚华	何贤	父亲
王璐瑶	王戈情	父亲
申若云	申大鹏	父亲
吴祖光	吴瀛	父亲
端木孝文	端木以善	父亲
厄内斯特·古尔比斯	Ainārs	父亲
郑经	郑成功	父亲
孙皓想	孙和作	父亲
谭咏麟	谭江柏	父亲
秦昭襄王	秦惠文王	父亲
陈先瑞	陈传卓	父亲
赵惠文王	武灵王	父亲
帕丽斯-迈克尔-凯瑟琳-杰克逊	迈克尔-杰克逊	父亲
方宏进	远洋船长	父亲
孔四贞	孔有德	父亲
乔治-巴顿	乔治-史密斯-巴顿	父亲
布拉	贝吉塔	父亲
杜雨露	杜志国	父亲
崔哲瀚	崔德淳	父亲
李好文	李凤	父亲
田北俊	田元灏	父亲
何超莲	何鸿燊	父亲
里夏德-阿道夫-席格蒙迪	阿道夫-席格蒙迪	父亲
经亨颐	经元善	父亲
辛夷	辛青山	父亲
马介璋	马明耀	父亲
李恪	唐太宗	父亲
西姆·布拉尔	阿维塔·布拉尔	父亲
拉希姆-阿尤	阿贝迪-贝利	父亲
史兰芽	史践凡	父亲
爱新觉罗·福宜	爱新觉罗·胤禛	父亲
费德里克-马切达	帕斯夸莱-马切达	父亲
符彦卿	符存审	父亲
谭韵寿	谭富英	父亲
希丹-彭尼蒂亚	Alan L Skip Panettiere	父亲
吴东迈	吴昌硕	父亲
张镇芳	张瑞祯	父亲
森喜朗	森茂喜	父亲
朱誉栾	朱彦淍	父亲
郑覃	郑珣瑜	父亲
查尔斯-摩根	皮特-摩根	父亲
妥灌帖睦尔	元明宗	父亲
沈宝钧	沈如璋	父亲
陈际泰	陈仪生	父亲
曹澳	曹峻	父亲
克里斯蒂亚诺-罗纳尔多-多斯桑托斯	罗纳尔多	父亲
查尔斯·罗尔斯	洛德兰加特克勋爵	父亲
侯玉兰	侯月亭	父亲
曾子墨	曾庆瑞	父亲
笛安	李锐	父亲
伊尔登	额亦都	父亲
王建中	王子	父亲
常贵田	常宝堃	父亲
毕胜	毕彰	父亲
谢永强	谢广坤	父亲
曹彰	曹操	父亲
张云成	张学臣	父亲
赵如兰	赵元任	父亲
周娥皇	周宗	父亲
燕侯舞	燕侯旨	父亲
大卫·贝克汉姆	爱德华·贝克汉姆	父亲
克莉丝汀-阿奎莱拉	弗斯脱·瓦格纳·赛维尔·阿奎莱拉	父亲
刘仲容	刘承烈	父亲
汪菊潜	汪显明	父亲
舞阳公主	汉顺帝	父亲
王予柔	王东生	父亲
潘毓刚	潘枢润	父亲
小佩德罗-阿门达雷兹	佩德罗-阿门达雷兹	父亲
向昊天	向伟	父亲
后稷	帝喾	父亲
曹桂芳	曹东扶	父亲
芭芭拉·贝卢斯科尼	西尔维奥·贝卢斯科尼	父亲
弗兰克-兰帕德	老兰帕德	父亲
全公主	孙权	父亲
明武宗	明孝宗	父亲
余派	余紫云	父亲
乔治-斐兹杰惹	威廉-斐兹杰惹	父亲
后水尾天皇	后阳成天皇	父亲
孙继海	孙亮宗	父亲
姬蒂-荷姆丝	马丁-约瑟夫-霍姆斯	父亲
吴待秋	吴伯滔	父亲
洪承畴	洪启熙	父亲
李调元	李化楠	父亲
罗浅浅	罗晓光	父亲
唐高祖第十九女	唐高祖	父亲
艾玛-汤普森	埃里克-汤普森	父亲
尼古拉·特斯拉	米卢廷·特斯拉	父亲
麦迪文	聂拉斯-埃兰	父亲
胡敦复	胡壹修	父亲
海瑞	海翰	父亲
卫青	郑季	父亲
戴安国	戴季陶	父亲
柔福帝姬	宋徽宗	父亲
侯玉兰	侯月亭	父亲
迪尔玛·罗塞夫	佩德罗·罗塞夫	父亲
阳含熙	阳师吕	父亲
刘半农	刘宝珊	父亲
狄娜	梁锡洪	父亲
何猷启	何鸿燊	父亲
方孝孺	方克勤	父亲
董良翮	董必武	父亲
舒俊榕	舒意龙	父亲
苏瑞·克鲁斯	汤姆·克鲁斯	父亲
马修-斯蒂文斯	莫雷尔-斯蒂文斯	父亲
罗穆卢斯	马耳斯	父亲
信都公主	唐太祖景皇帝	父亲
山本勘助	山本贞幸	父亲
吴伯雄	吴鸿麟	父亲
爱新觉罗-纳尔苏	爱新觉罗-纳尔福	父亲
王辩	王翔千	父亲
爱新觉罗-福沛	爱新觉罗-胤禛	父亲
宝庆公主	明太祖朱元璋	父亲
王承裕	王恕	父亲
周平王	周幽王	父亲
冯金芙	冯蕙林	父亲
冯目田	冯镜如	父亲
唐若昕	唐弢	父亲
刘英娥	宋文帝刘义隆	父亲
刘畅	刘永好	父亲
吴焕先	吴维棣	父亲
小林泉美	小林光一	父亲
杜丽	石兴法	父亲
兴平公主	辽圣宗	父亲
甄梦初	甄显松	父亲
胡培翚	胡秉钦	父亲
汤子同	汤君年	父亲
马增祥	马连登	父亲
爱新觉罗-绵忻	爱新觉罗颙琰	父亲
玛蒂尔达·莱杰	希斯·莱杰	父亲
乔治-图普五世	陶法阿豪-图普四世	父亲
刘子千	刘家昌	父亲
陈明珠	陈汉秋	父亲
周秉建	周恩寿	父亲
贾元春	贾政	父亲
李祖铭	李慕良	父亲
鲍吉祥	鲍福山	父亲
田佳	田卫国	父亲
李默庵	李笠云	父亲
朗素	明安	父亲
程继先	程章圃	父亲
张语芯	张纪中	父亲
文君竹	文章	父亲
陈翰笙	陈觉先	父亲
易耀彩	易宇爽	父亲
蔡畅	蔡蓉峰	父亲
维罗-史密斯	威尔-史密斯	父亲
蔡岳勋	蔡扬名	父亲
叶福海	叶忠定	父亲
张译元	张树林	父亲
朱橞	朱元璋	父亲
王海成	王洛宾	父亲
陈晓凤	陈广谦	父亲
莫叶	莫人英	父亲
刘裕	刘翘	父亲
张瑞芬	张舜炳	父亲
张纯如	张绍进	父亲
孛儿只斤·蒙哥	孛儿只斤·拖雷	父亲
吐奴傀	车鹿会	父亲
嬴则	秦惠文王	父亲
凯文-拉夫	斯坦-拉夫	父亲
程璋	程鉴堂	父亲
晋愍帝	司马晏	父亲
陆逊之妻	孙策	父亲
吴镇	吴禾	父亲
艾蜜莉-戴丝香侬	Caleb Deschanel	父亲
凯西·强生	罗伯特·强生	父亲
侯瓒	侯耀文	父亲
立原久纲	立原幸纲	父亲
李娜	李平春	父亲
章敬皇后	王圭	父亲
谭元寿	谭富英	父亲
埃舍尔	George	父亲
马珏	马幼渔	父亲
殷野王	殷天正	父亲
长宗我部元亲	长宗我部国亲	父亲
王淑明	王隆夫	父亲
小雅琳	谭向平	父亲
七龄童	章益生	父亲
刘庚生	刘仁政	父亲
慕沙	缅甸王猛白	父亲
韩宗道	韩综	父亲
王延霞	王洪武	父亲
蒋春霖	蒋尊典	父亲
时沅	时大经	父亲
戴王纶	戴明说	父亲
桓雄	桓因	父亲
曹丕	曹霖	父亲
瑞恩-戴	凯文	父亲
江都公主	刘建	父亲
小道格拉斯-范朋克	道格拉斯-范朋克	父亲
周凤文	周钊泉	父亲
王鑫	王明杰	父亲
崔妃	崔峋	父亲
何猷佳	何鸿燊	父亲
哈曼-卡恩	马哈拉加-康	父亲
蔡赟	蔡四官	父亲
邓园	邓文才	父亲
罗克斯·劳	罗布·劳	父亲
马特-德拉吉	罗伯特-德拉吉	父亲
司马炎	司马昭	父亲
王葆仁	王锡山	父亲
贺启敏	贺鸣玉	父亲
虢国夫人	杨玄琰	父亲
理查德·加里奥特	欧文·加里奥特	父亲
吴雨	吴英明	父亲
沈婺华	沈君理	父亲
宋昭公	宋成公	父亲
孙策	孙坚	父亲
吴敬琏	吴竹似	父亲
孟鸿茂	孟福保	父亲
刘恂	刘禅	父亲
周一良	周叔弢	父亲
袁隆平	袁兴烈	父亲
孙盛芳	孙小华	父亲
汪曾祺	汪菊生	父亲
黄孟复	黄竞武	父亲
马克西玛·索雷吉耶塔	若热·索雷吉耶塔	父亲
陈璧君	陈耕基	父亲
月眉儿	上官飞龙	父亲
曾海生	曾山	父亲
萧红	张廷举	父亲
慕容评	慕容廆	父亲
郭素素	郭子豪	父亲
比尔盖茨	威廉盖茨	父亲
唐太宗李世民生母窦氏	窦毅	父亲
丁绍光	丁俊生	父亲
詹姆斯·默多克	鲁伯特·默多克	父亲
萧圣谚	萧尧	父亲
襄城公主	唐太宗	父亲
纳伊夫·本·阿卜杜勒-阿齐兹	阿卜杜勒-阿齐兹·伊本·沙特	父亲
布里奇曼	雷蒙德-兰登-布里奇曼	父亲
刘淦飞	刘家驹	父亲
范志毅	范九林	父亲
李歆	李皓	父亲
韩昭侯	韩懿侯	父亲
李文	李敖	父亲
黛米-洛瓦托	柏德烈-洛瓦特	父亲
贾丽川	贾树堂	父亲
程树棠	文焕亭	父亲
朱维亮	朱培德	父亲
彭士禄	彭湃	父亲
谢启大	谢鸿轩	父亲
沃尔夫冈-阿玛多伊斯-莫扎特	列奥波尔得-莫扎特	父亲
石三泰	观音保	父亲
秦沛	严化	父亲
殷明珠	殷星环	父亲
孔明	孔太公	父亲
叶莉	叶发	父亲
陈霖苍	陈永玲	父亲
陈炽	陈唯楫	父亲
谢天顺	谢舒扬	父亲
秦庄襄王	秦孝文王柱	父亲
郑维山	郑国麒	父亲
刘濞	刘仲	父亲
张宾	张瑶	父亲
袁晓超	袁新亮	父亲
马东	马季	父亲
王令麟	王又曾	父亲
丽芙·泰勒	斯蒂文·泰勒	父亲
蔡万春	蔡福安	父亲
朱夫人	朱据	父亲
固伦和敬公主	爱新觉罗·弘历	父亲
马修-史蒂文斯	莫雷尔-斯蒂文斯	父亲
周洋	周继文	父亲
李梅菊	李风才	父亲
彻尔格	额亦都	父亲
巧姐	贾琏	父亲
梅葆玖	梅兰芳	父亲
克洛诺斯	乌拉诺斯	父亲
包小柏	包振铭	父亲
爱新觉罗-胤禵	爱新觉罗-玄烨	父亲
于紫云	于豹	父亲
李昌钰	李浩民	父亲
林忠豪	林孝文	父亲
阿兰-琼斯	斯坦-琼斯	父亲
齐世英	齐鹏大	父亲
李韵秋	李永华	父亲
胡太后	胡国珍	父亲
伊萨贝尔·多斯·桑托斯	若泽·爱德华多·多斯·桑托斯	父亲
宋太祖	赵弘殷	父亲
威廉·塔夫脱	阿方索·塔夫脱	父亲
毛东东	毛新宇	父亲
白云鹏	白凤林	父亲
黎嘉敏	黎锡锦	父亲
邵庆元	邵子美	父亲
金庸武侠小说中的人物-射雕英雄传女主角	东邪黄药师	父亲
胡斐	胡一刀	父亲
郑小龙	古龙	父亲
上杉谦信	长尾为景	父亲
楚熊杨	楚熊胜	父亲
耶律燕哥	豁里斯	父亲
约翰-肯尼迪	约瑟夫-肯尼迪	父亲
师胜杰	师世元	父亲
孔杰	孔繁森	父亲
党毅飞	党晓兵	父亲
姬宫湦	姬静	父亲
瑞比-杰克森	Joseph Jackson	父亲
刘昌祚	刘贺	父亲
沈周	沈恒吉	父亲
李光耀	李进坤	父亲
杨凌波	杨焕林	父亲
哪吒	李靖	父亲
亚历山德拉·科斯坚纽克	康斯坦丁·科斯坚纽克	父亲
吕夷简	吕蒙亨	父亲
王国平	王平夷	父亲
加西夫	沙拉曼	父亲
桓思窦皇后	窦武	父亲
胡安·马丁·德尔波特罗	丹尼尔·德尔波特罗	父亲
爱新觉罗-永琏	乾隆皇帝	父亲
李可染	李会春	父亲
鄂齐尔桑	巴克	父亲
近卫文麿	近卫笃麿	父亲
阿尔弗雷德·诺贝尔	艾马纽·诺贝尔	父亲
尼格尔·德容	杰里·德容	父亲
陈小轩	陈家昌	父亲
鲍泉	鲍机	父亲
顾其行	顾薄华	父亲
哈珀-塞文-贝克汉姆	大卫-贝克汉姆	父亲
严歌苓	萧马	父亲
司马道赐	司马国镇	父亲
卡伦-乔哈尔	Yash Johar	父亲
托马斯·戴利	罗伯特·戴利	父亲
甄姬	甄逸	父亲
窦蔻	窦玉明	父亲
贾登-史密斯	威尔-史密斯	父亲
梅根-纳伊	罗伯特-纳伊	父亲
卡米耶·毕沙罗	亚伯拉罕·加百列·毕沙罗	父亲
张慧冲	张子林	父亲
卢璐	卢华芳	父亲
麻贵	麻禄	父亲
邵山客	邵玉轩	父亲
张永和	张开济	父亲
何塞·卡马乔	安东尼奥	父亲
耿少峰	耿永峰	父亲
吕大忠	吕蕡简	父亲
李天骥	李玉琳	父亲
蔡卓妍	蔡威臣	父亲
王朔	王志才	父亲
吕葆中	吕留良	父亲
陈大愚	陈佩斯	父亲
芒努斯-卡尔森	亨里克-卡尔森	父亲
王肃	父王朗	父亲
玛莉丝卡-哈吉塔	麦琪-哈吉塔	父亲
韦粲	韦放	父亲
常东升	常兰亭	父亲
金翠莲	金二	父亲
梁武帝萧衍与皇后郗徽第二女萧玉婉	梁武帝萧衍	父亲
杨宝森	杨孝方	父亲
陈嘉梁	陈寿峰	父亲
李度崘	李昌郁	父亲
宋桓公	宋庄公	父亲
南希-里根	肯家斯-罗宾斯	父亲
李重茂	李显	父亲
郑如萍	郑钺	父亲
柯宇纶	柯一正	父亲
吴承恩	吴锐	父亲
马廷用	马铎	父亲
张洁雯	张耀辉	父亲
完颜庆山奴	使拐山之	父亲
爱新觉罗-永璟	爱新觉罗-弘历	父亲
蒋介石	蒋肇聪	父亲
凯末尔	阿里·里札	父亲
彭家元	彭士勋	父亲
霍皇后	霍光	父亲
孙文妍	孙裕德	父亲
南勇	南兴烈	父亲
朱偕浰	朱征钤	父亲
吴征镒	吴启贤	父亲
高世寿	高庆奎	父亲
西莱斯特-霍姆	霍姆	父亲
胡贵嫔	胡奋	父亲
约翰·麦凯恩	小约翰·席德尼·麦凯恩	父亲
钱伟长	钱声一	父亲
孟祥斌	孟繁荣	父亲
独孤库	俟尼	父亲
江上青	江石溪	父亲
谢升	谢廷策	父亲
马修·福克斯	法兰西斯·福克斯	父亲
胡婷婷	胡志强	父亲
莲舫	谢哲信	父亲
金少山	金秀山	父亲
郭志鸿	郭沫若	父亲
赵本山	赵德仁	父亲
孙婉	孙中山	父亲
李霞卿	李应生	父亲
西蒙·波娃	乔治·德·波伏瓦	父亲
孙权	孙休	父亲
白玉珍	白建桥	父亲
科赫兄弟	弗雷德-科赫	父亲
云昭训	云定兴	父亲
贾祥瑞	贾增寿	父亲
李九莲	李忠华	父亲
舟舟	胡厚培	父亲
张增熙	张宝善	父亲
金玉书	金仲仁	父亲
刘鸿生	刘贤喜	父亲
嘉庆	乾隆皇帝	父亲
龙榆生	龙赓言	父亲
张学济	张君秋	父亲
岳灵珊	岳不群	父亲
赫舍里·索尼	硕色	父亲
司马令姬	司马消难	父亲
李昭	李仲侯	父亲
琼恩·雪诺	艾德·史塔克	父亲
王凤	王龙兴	父亲
吴秀艳	吴秋良	父亲
宋子凌	宋恩杰	父亲
邢胜奎	邢洪培	父亲
晋陵公主	孝武帝司马曜	父亲
朱模	朱元璋	父亲
速不台	哈班	父亲
钱应溥	钱泰吉	父亲
维奥莱特	力库·多尔德3世	父亲
朱徽煝	朱楩	父亲
邵华	陈振亚	父亲
保罗·塞尚	路易·奥古斯都·塞尚	父亲
李锡祺	李培芳	父亲
吕光	吕婆楼	父亲
赫尔曼·莫里斯·萨克斯伯爵	奥古斯特二世	父亲
汪厥明	汪茂榕	父亲
姜延静	姜永业	父亲
刘平平	刘少奇	父亲
小泉信子	小泉纯也	父亲
欧阳倩	欧阳钟	父亲
孙天瑞	孙峰	父亲
金汝静	金正日	父亲
王娡	王仲	父亲
室伏广治	室伏重信	父亲
潘鼎新	潘璞	父亲
马科-贾里奇	斯莱克-贾里奇	父亲
禳命女	雅狄王	父亲
傅亨	傅作义	父亲
关统	关兴	父亲
陈素花	陈天宝	父亲
帝辛	帝乙	父亲
布莱丝-达拉斯-霍华德	朗-霍华德	父亲
固伦和孝公主	爱新觉罗·弘历	父亲
乔治·斐兹杰惹	威廉·斐兹杰惹	父亲
王屾	王春山	父亲
代雯奇	泰歌	父亲
陈蓉芳	陈嘉麟	父亲
江玉郎	江别鹤	父亲
刘亭	刘少奇	父亲
恩佐·齐达内	齐内丹·齐达内	父亲
郝笛	郝文敏	父亲
朱培德	朱秉堃	父亲
杰夫-贝佐斯	Miguel Bezos	父亲
钟代胜	锺万友	父亲
朱湛之	朱云水	父亲
埃瓦尔德·海因里希·冯·克莱斯特	埃瓦尔德·冯克莱斯特	父亲
姚依林	姚捷勋	父亲
陈维黛	陈树德	父亲
齐格蒙特三世	约翰三世	父亲
谢奕	谢裒	父亲
羊鉴	羊济	父亲
莫华伦	莫庆义	父亲
长孙无忌	长孙晟	父亲
高韵笙	高庆奎	父亲
吴协恩	吴仁宝	父亲
亚森·罗平	泰奥弗拉斯特·罗平	父亲
张子石	康生	父亲
姬壬臣	周襄王	父亲
梁皓贻	梁家仁	父亲
严庆龄	严裕棠	父亲
郭皇后	郭暧	父亲
周如松	周鲠生	父亲
杨毅	杨少华	父亲
李元亨	李渊	父亲
孙芸芸	孙道存	父亲
埃及艳后	托勒密十二世	父亲
梁文茜	梁实秋	父亲
桂元澄	桂广澄	父亲
尼基-柏恩	尼可拉斯	父亲
邹俊杰	邹永强	父亲
张志沂	张佩纶	父亲
四世达赖	青格尔杰布彻辰曲吉	父亲
田雨橙	田亮	父亲
霍东阁	霍元甲	父亲
卢琳	卢炳新	父亲
刘向蕙	刘德华	父亲
苏我入鹿	苏我虾夷	父亲
陆冠英	陆乘风	父亲
徐景藩	徐省三	父亲
李叔福	李赞臣	父亲
杰西卡-阿尔芭	马克-阿尔巴	父亲
杜志国	杜雨露	父亲
宁平公主	刘钦	父亲
曹禺	万德尊	父亲
周美青	周兆溎	父亲
郑亚旗	郑渊洁	父亲
袁田	袁阔成	父亲
谢凌霄	谢东	父亲
升国大长公主	宋真宗	父亲
陈自强	陈小兴	父亲
李宁	李世波	父亲
阮籍	阮瑀	父亲
阎晶晶	阎维文	父亲
陈必亨	陈腾伟	父亲
张振圻	张小泉	父亲
潘世墨	潘懋元	父亲
贾宏声	贾凤森	父亲
元辉	尹灵光	父亲
日本女子体操队队长田中理惠	田中章二	父亲
格罗弗·克利夫兰	理查德·法利·克利夫兰	父亲
张居礼	张灵甫	父亲
宣化上人	富海公	父亲
姚祺儿	姚慕双	父亲
贞子	伊熊平八郎	父亲
靓少佳	谭杰南	父亲
特兰克斯	贝吉塔	父亲
谢灵运	谢瑛	父亲
胡应时	胡光	父亲
梅根-罗西	维恩-罗西	父亲
宛金秋	宛洪义	父亲
朱膺鐩	朱音垫	父亲
桑德罗·马佐拉	瓦伦蒂诺·马佐拉	父亲
侣海岩	侣皓吉吉	父亲
林跃	林耀泉	父亲
施尼茨勒	Johann	父亲
乐蒂	奚兆年	父亲
安德烈-纪德	保尔-纪德	父亲
周波	周永明	父亲
维奥莱特	力库-多尔德3世	父亲
小式部内侍	橘道贞	父亲
米高-辛	Meyrick	父亲
张学济	张君秋	父亲
邓永佳	邓长富	父亲
郑厘公	郑成公	父亲
朱传文	朱开山	父亲
卓布泰	卫齐	父亲
方润华	方树泉	父亲
潘迪生	潘锦溪	父亲
魏永康	魏炳南	父亲
谢龙旺	谢景森	父亲
付豪	付笛生	父亲
阿古	猛哥帖木儿	父亲
杨元元	杨荫东	父亲
侯耀文	侯宝林	父亲
齐如山	齐禊亭	父亲
格兰特-希尔	开尔文-希尔	父亲
小泉纯一郎	小泉纯也	父亲
李丹宇	李雪锋	父亲
汤一介	汤用彤	父亲
阿尔津	齐玛塔	父亲
格桑嘉措	索南达结	父亲
薛夜来	薛业	父亲
王铭章	王文焕	父亲
孟明视	百里奚	父亲
彭小莲	彭柏山	父亲
玛丽-切尼	迪克-切尼	父亲
爱新觉罗-永珹	爱新觉罗-弘历	父亲
宋楚瑜	宋达	父亲
萧衍	萧顺之	父亲
大卫二世	罗伯特-布鲁斯	父亲
吴承瑛	吴乐之	父亲
孟晚舟	任正非	父亲
吕思勉	吕德骥	父亲
沃伊切赫·什琴斯尼	马切伊·什琴斯尼	父亲
许晋亨	许世勋	父亲
马任全	马润生	父亲
曹德旺	曹晖	父亲
傅周海	傅耀章	父亲
黄炎培	黄叔才	父亲
郑继凤	郑森	父亲
张晓兵	张特荪	父亲
杨戬	杨天佑	父亲
王雁南	赵紫阳	父亲
菲丝希尔	Ted	父亲
冯波	冯之浚	父亲
乔瑟夫-高登-李维	丹尼斯-拉维特	父亲
蔡安妮	蔡长年	父亲
安定公主	李治	父亲
黄志千	黄津香	父亲
许士芬	许爱周	父亲
罗克斯-劳	罗布-劳	父亲
孙冶方	薛端性	父亲
马克斯-普朗克	威廉-约翰-尤利乌斯-普朗克	父亲
白薇	黄晦	父亲
饶安公主	唐宣宗李忱	父亲
张元智	张连福	父亲
平原公主	元怀	父亲
阿旺嘉措	布珠	父亲
侯玉琢	侯勇	父亲
刘忠庆	贾同才	父亲
京兆公主	司马昭	父亲
威廉·赫歇尔	艾萨克	父亲
王又曾	王简文	父亲
布伦特-巴里	里克-巴里	父亲
林苍佑	林萃龙	父亲
杨升庵	杨廷和	父亲
盛宣怀	盛康	父亲
蒋锡夔	蒋国榜	父亲
朱瑞	朱惠	父亲
段林希	段宝生	父亲
徐鹤林	徐紫满	父亲
郭子睿	郭涛	父亲
包伟铭	包振铭	父亲
傅天正	傅志清	父亲
郝艳芳	郝英吉	父亲
爱新觉罗·弘晖	爱新觉罗·胤禛	父亲
左安安	左宏元	父亲
吴敬梓	吴雯延	父亲
何超欣	何鸿燊	父亲
刘长	刘邦	父亲
桑德拉-拉露卡-伊兹芭萨	Florin Nicolae	父亲
龚琪	龚长青	父亲
王薇薇	王澄清	父亲
薛蛮子	薛子正	父亲
宗毓华	宗凌曾	父亲
史朝义	史思明	父亲
朱瞻垍	明仁宗朱高炽	父亲
安-海瑟薇	杰拉德-海瑟薇	父亲
凯文-乐福	斯坦-拉夫	父亲
沈宁	沈苏儒	父亲
黄恺杰	黄锦燊	父亲
程正谊	程梓	父亲
赵会	赵永发	父亲
曾文仲	曾纪华	父亲
泰夏安-普林斯	托马斯	父亲
本堂瑛佑	伊桑·本堂	父亲
雷锋	雷明亮	父亲
钱君匋	钱熙林	父亲
和熹邓皇后	邓训	父亲
胡芳	胡奋	父亲
安吉-穆洛兹	马斯	父亲
史蒂芬·席格	史蒂芬	父亲
唐太宗第三子	唐太宗李世民	父亲
李敬玄	李孝节	父亲
马天如	马益彰	父亲
陈百强	陈鹏飞	父亲
周公旦	周文王	父亲
段君毅	段子敬	父亲
徐舜寿	徐一冰	父亲
陈瑞鸿	陈瑞槐	父亲
托比·斯蒂芬斯	罗伯特·斯蒂芬斯	父亲
林四秀	苏连勇	父亲
赫舍里·噶布喇	索尼	父亲
房俊	房玄龄	父亲
王明杰	王鑫	父亲
黄文焕	黄传春	父亲
何冲	何平	父亲
临真公主	唐德宗李适	父亲
丁楚	丁其彦	父亲
陈琏	陈布雷	父亲
麦嘉轩	麦法诚	父亲
降谷建志	古谷一行	父亲
张弘靖	张文规	父亲
明世宗	朱祐杬	父亲
晋惠帝	司马炎	父亲
理查德-加里奥特	欧文-加里奥特	父亲
楚文王	楚武王	父亲
怀嬴	秦穆公	父亲
安立奎·伊格莱希亚斯	胡里奥·伊格莱西亚斯	父亲
姚宇	姚庆柱	父亲
富田重政	山崎景邦	父亲
刘振华	刘承占	父亲
祁理孙	祁彪佳	父亲
今川义元	今川氏亲	父亲
朱燕来	朱镕基	父亲
赵庄子	赵宣子	父亲
熊秉明	熊庆来	父亲
纯惠皇贵妃	苏召南	父亲
王昌豹	王乃水	父亲
陆喜明	陆连贵	父亲
潘振镛	潘大临	父亲
威廉·伦道夫·赫斯特	乔治·赫斯特	父亲
范小建	范长江	父亲
科勒·卡戴珊	罗伯特·卡戴珊	父亲
徐帆	徐大树	父亲
爱玛-沃特森	Chris Watson	父亲
王昆仑	王心如	父亲
阿伦·埃弗森	迈克尔·弗里曼	父亲
卡梅隆·道格拉斯	迈克尔·道格拉斯	父亲
东莪	多尔衮	父亲
拓跋绍	道武帝	父亲
十二世达赖	彭措才旺	父亲
陈师曾	陈三立	父亲
欧仁-德拉克罗瓦	C德拉克洛瓦	父亲
王田霞	王德臣	父亲
李俊毅	李鸿禧	父亲
蔡伯翰	蔡辰洋	父亲
徐长秀	徐观金	父亲
宋光宗	宋孝宗	父亲
迪迪埃·德库安	亨利德库安	父亲
孔楚白	孔宪儒	父亲
段存让	段君毅	父亲
杀生丸	犬大将	父亲
黛安娜·范斯坦	里昂·戈德曼	父亲
李敢	李广	父亲
巴伦-特朗普	唐纳德-特朗普	父亲
袁小海	袁世海	父亲
覃子豪	覃裕兴	父亲
马亚文	马四喜	父亲
固伦和孝公主	爱新觉罗-弘历	父亲
陆九渊	陆贺	父亲
王珂	王恩来	父亲
敏达天皇	钦明天皇	父亲
高坂昌信	春日大隈	父亲
梅兰芳	梅竹芬	父亲
冉闵	冉瞻	父亲
英若诚	英千里	父亲
朱干蛙	朱定煠	父亲
小约瑟夫·赫尔梅斯伯格	约瑟夫·赫尔梅斯伯格	父亲
曹雪	曹凤文	父亲
李明捷	李国凯	父亲
陈兆棠	陈士杰	父亲
珊莎·史塔克	艾德·史塔克	父亲
张玄锡	张骏	父亲
夏太祖	李光俨	父亲
贾维尔·麦基	乔治·蒙哥马利	父亲
爱新觉罗-福惠	爱新觉罗-胤禛	父亲
战国时期赵武灵王之妻	吴广	父亲
袁熙坤	袁晓岑	父亲
桑迪-威尔	麦克-威尔	父亲
塞奥菲罗斯	米哈伊尔二世	父亲
玛格利特-撒切尔	亚佛列罗伯茨	父亲
蔡博	蔡和森	父亲
宋徽宗	宋神宗	父亲
徐锡麟	徐梅生	父亲
元太祖	孛儿只斤·也速该把阿秃儿	父亲
陈司翰	陈崇伟	父亲
吴观灡	吴锡荣	父亲
李裹儿	李显	父亲
丰田章男	丰田章一郎	父亲
李裹儿	唐中宗	父亲
金正恩	金正日	父亲
陈懿	陈孝怡	父亲
德拉科·马尔福	卢修斯·马尔福	父亲
左宗棠	左观澜	父亲
赵维勤	赵忠尧	父亲
石原伸晃	石原慎太郎	父亲
牙忽都	睿宗	父亲
戈公振	戈铭烈	父亲
黑羽快斗	黑羽盗一	父亲
刘秩	刘知几	父亲
王哲林	王昌海	父亲
莉莉艾伦	基思·艾伦	父亲
哈吉-哈桑纳尔-博尔基亚	奥玛阿里赛尔夫汀三世	父亲
王筱翠	王杰	父亲
贾敬	贾代化	父亲
梁宗巨	梁星坡	父亲
达尔党阿	阿灵阿	父亲
麦考利-卡尔金	克里斯多弗-卡尔金	父亲
唐玄宗之女	唐玄宗李隆基	父亲
华叔阳	华察	父亲
始平公主	晋惠帝	父亲
丹尼尔·韦斯特林	奥勒·韦斯特林	父亲
凯特-哈德森	Bill Hudson	父亲
李启明	李刚	父亲
汉景帝	汉文帝	父亲
袁了凡	袁仁	父亲
服部平次	服部平藏	父亲
杜婧	杜永富	父亲
乔治二世	乔治一世	父亲
周幼马	马海德	父亲
左塞尔	卡塞凯姆威	父亲
高拱	高尚贤	父亲
梁武帝	梁文帝	父亲
德川家康	松平广忠	父亲
陈湙静	陈思溢	父亲
晋惠帝	晋武帝	父亲
蒂亚戈·梅西	里奥·梅西	父亲
诸邑公主	刘彻	父亲
金德富	金茂胜	父亲
袁世文	袁林学	父亲
爱新觉罗-胤禄	康熙帝	父亲
阿道夫-希特勒	阿洛伊斯-希特勒	父亲
张润贞	何文协	父亲
席维斯·史泰龙	弗兰克·史泰龙	父亲
徐如云	徐小香	父亲
陈敏熏	陈重义	父亲
李宸妃	李仁德	父亲
孙国庆	孙肖平	父亲
陈玉申	陈富瑞	父亲
奇犽	席巴	父亲
金汝贞	金正日	父亲
王大钧	王业	父亲
许浚	许纶	父亲
李景隆	李文忠	父亲
爱新觉罗-满达海	代善	父亲
琳赛·罗翰	迈克尔·洛翰	父亲
何超贤	何鸿燊	父亲
竹田恒和	竹田恒德	父亲
根敦朱巴	贡保多吉	父亲
张琳	张仲泉	父亲
和硕和嘉公主	爱新觉罗-弘历	父亲
贝尔·格里尔斯	迈克尔·格里尔斯	父亲
秦玉芳	秦志	父亲
冯军全	冯泽阳	父亲
赵惇	宋孝宗	父亲
路易丝-布朗	约翰-布朗	父亲
六小龄童	六龄童	父亲
房祖名	成龙	父亲
姚贝娜	姚峰	父亲
周惠	周俊卿	父亲
文强	文明君	父亲
王晶	王天林	父亲
高演	高欢	父亲
赵世彭	赵从衍	父亲
科洛普顿	威廉-科洛普顿	父亲
梁元帝	萧衍	父亲
上条当麻	上条刀夜	父亲
谢才彬	谢文华	父亲
程小东	程刚	父亲
盖莱蒂·久尔基	盖莱蒂·捷尔吉	父亲
张祚	张骏	父亲
莱西-察伯特	汤尼-察伯特	父亲
王凤朝	王歧山	父亲
曹真	秦邵	父亲
潘卓华	潘兆棠	父亲
三浦佑太郎	三浦友和	父亲
文群	文廷式	父亲
齐康公	齐宣公吕积	父亲
杨元咏	杨宝忠	父亲
陈玉田	陈世荣	父亲
乔丹-阿尤	阿贝迪-贝利	父亲
孙坚	孙钟	父亲
许有美	许观光	父亲
张承宗	张昌龄	父亲
张池明	张彦邦	父亲
毛甜懿	毛新宇	父亲
诸葛恪	诸葛瑾	父亲
马世嫒	马景涛	父亲
司马迁	司马谈	父亲
赵昀	赵扩	父亲
金正哲	金正日	父亲
周睿羊	周明镭	父亲
鸟居忠广	鸟居忠吉	父亲
刘向	刘德	父亲
萧绎	梁武帝	父亲
哈达哈	傅尔丹	父亲
哈莉	杰罗姆	父亲
小约翰-施特劳斯	约翰-施特劳斯	父亲
鲍里斯	阿洛伊斯-克拉伊盖尔	父亲
穆尔哈齐	塔克世	父亲
朱天心	朱西宁	父亲
宗庆后	宗启騄	父亲
王庆平	王泽富	父亲
李治	李世民	父亲
卡拉·布吕尼	阿尔贝托·布吕尼·蒂戴西	父亲
长孙无垢	长孙晟	父亲
贺本	贺高强	父亲
全绪	全琮	父亲
李树芬	李秀华	父亲
韩简	韩赇伯	父亲
柏拉图	阿里斯通	父亲
韩定伯	韩赇伯	父亲
夏明衡	夏绍范	父亲
林孝贤	林建岳	父亲
朱融焚	朱旭橦	父亲
林以宁	林纶	父亲
福原爱	武彦	父亲
张放	张灯	父亲
曹湘石	曹心泉	父亲
杨振雄	杨斌奎	父亲
凯特-温斯莱特	罗杰-温斯莱特	父亲
王若萱	王大洪	父亲
术赤	成吉思汗	父亲
沈佳润	小沈阳	父亲
李晶晶	李克潮	父亲
雷蕾	雷振邦	父亲
亚历山大二世	尼古拉一世	父亲
谢僧要	谢尚	父亲
黎龙钺	黎桓	父亲
陈致远	陈进国	父亲
李元元	李逸生	父亲
李小林	巴金	父亲
切尔西·克林顿	比尔·克林顿	父亲
奥丽维亚-德哈维兰	沃特-德哈维兰	父亲
孙诗雯	秦汉	父亲
汉昭帝	汉武帝	父亲
杨景辉	杨定富	父亲
比利-乔	Andy Armstrong	父亲
严农	严怪愚	父亲
高桥是清	川村庄右卫门守房	父亲
许弘纲	许文清	父亲
岸田文雄	岸田文武	父亲
敬隐宋皇后	宋杨	父亲
伊图	德世库	父亲
阿曼达-拜恩斯	瑞克	父亲
刘爱琴	刘少奇	父亲
谭天健	谭炳训	父亲
邱凤翔	邱炳泉	父亲
克莉丝-阿基诺	贝尼诺-阿基诺	父亲
贺锡敬	贺鸣玉	父亲
曹世嘉	曹瑞石	父亲
陈梓材	陈跃龙	父亲
吴冠中	吴圹北	父亲
柳涵香	爱新觉罗-玄烨	父亲
王士光	王治昌	父亲
凯瑟琳-海格	保罗-海格尔	父亲
焦刘洋	焦春松	父亲
奥黛莉·赫本	约瑟夫·维克特·A·赫本-鲁斯顿	父亲
朱世开	朱安旭	父亲
张默	张国立	父亲
迪伦-劳伦	拉尔夫-劳伦	父亲
王之垣	王重光	父亲
李玉双	李可染	父亲
李保良	李盈台	父亲
张君秋	滕联芳	父亲
杨延平	金刀老令公杨业	父亲
张无疾	张有福	父亲
刘宪章	刘克昌	父亲
赵菁	赵明勇	父亲
梁邦楚	梁敬斋	父亲
富兰克林	乔赛亚·富兰克林	父亲
张业琳子	张儒兵	父亲
陶李	陶然	父亲
小灰灰	灰太狼	父亲
李坏	李曼青	父亲
刘节	刘景晨	父亲
钱桂蟾	钱如兰	父亲
麦升阳	麦幸夫	父亲
陈晓翠	陈武斌	父亲
顾仲起	顾乐亭	父亲
吴兆基	吴兰荪	父亲
谭安琪	谭广志	父亲
苏炳添	苏照华	父亲
木吒	托塔李天王	父亲
谭月清	谭焕堂	父亲
细川护熙	细川护贞	父亲
陆小芬	陆玉凤	父亲
葛晓洁	高凌风	父亲
艾丽西亚-西尔维斯通	蒙迪-西尔维斯通	父亲
刘献炜	刘朝彬	父亲
韦恩·鲁尼	汤马士·韦恩·鲁尼	父亲
王闳	王谭	父亲
祁宏	祁光华	父亲
金田一春彦	金田一京助	父亲
张宗宪	张仲英	父亲
魏武侯	魏文侯	父亲
曹丕	曹操	父亲
丁聪	丁悚	父亲
王秀之	王瓒之	父亲
亨利·卢梭	朱利安·卢梭	父亲
马汀·劳伦斯	约翰·劳伦斯	父亲
宇文阐	宇文赟	父亲
张晓风	胡风	父亲
桓玄	桓温	父亲
薛讷	薛仁贵	父亲
夷安公主	刘彻	父亲
新艳秋	王海山	父亲
孙穗芳	孙科	父亲
王秀玲	王俊卿	父亲
姜贵	王鸣柯	父亲
爱新觉罗-永瑆	乾隆皇帝	父亲
郭奇林	郭德纲	父亲
邓兆尊	邓永祥	父亲
拉克兰·默多克	鲁伯特·默多克	父亲
日野资名	日野俊光	父亲
曹霖	曹髦	父亲
孛儿只斤·海山	孛儿只斤·答剌麻八剌	父亲
阿尔贝二世	利奥波德三世	父亲
邓世昌	邓焕庄	父亲
向华强	向前	父亲
茹富兰	茹锡九	父亲
钟隽仪	钟建伟	父亲
冯喆	冯大刚	父亲
包郎阿	福满	父亲
王丽嘉	王敏德	父亲
小王彬彬	王彬彬	父亲
郝柏村	郝绪龄	父亲
罗福颐	罗振玉	父亲
蒋友梅	蒋孝文	父亲
罗恩-韦斯莱	亚瑟-韦斯莱	父亲
吴坛	吴绍诗	父亲
汤淼	汤和平	父亲
艾斯蒂尔-布莱特和约修亚-布莱特	卡西乌斯-布莱特	父亲
道格-李曼	阿瑟-L-李曼	父亲
钱棅	钱士升	父亲
朱莉·安德鲁丝	爱德华·特德·韦尔斯	父亲
赵元淑	赵世模	父亲
李源朝	李干臣	父亲
时纯利	时传祥	父亲
陈丽达	陈强	父亲
克里斯蒂娜·阿奎莱拉	弗斯脱·瓦格纳·赛维尔·阿奎莱拉	父亲
刘乙麟	刘德一	父亲
张玄靓	张重华	父亲
美智子	正田英三郎	父亲
罗尼-图里亚夫	塞萨尔	父亲
张良	张兆喜	父亲
伊娃·阿穆里	弗兰克·阿穆里	父亲
宫傲	宫进生	父亲
吕敏	吕叔湘	父亲
任伯年	任声鹤	父亲
刘义符	宋武帝	父亲
房祖名 	成龙	父亲
侬智高	侬全福	父亲
李沛瑶	李济深	父亲
王尔卓	王建强	父亲
玛丽娅	萨金特-施莱弗	父亲
梅雨田	梅巧玲	父亲
后小松天皇	后圆融天皇	父亲
曹永安	曹东扶	父亲
源义朝	源为义	父亲
李恒建	李春江书画家	父亲
李雄	李特	父亲
梁丹妮	梁信	父亲
贾南德拉	马亨德拉	父亲
谭嗣同	谭继洵	父亲
艾丽·范宁	史帝夫·范宁	父亲
英若诚	英骥良	父亲
丁琪	丁传靖	父亲
王灵宾	王骞	父亲
罗康瑞	罗鹰石	父亲
路易十四	路易十三	父亲
瑞安公主	明穆宗	父亲
司马昭	司马懿	父亲
吕钢	吕干邦	父亲
唐在炘	唐至上	父亲
许恒瑞	许文林	父亲
安淑帝姬	宋徽宗	父亲
李世源	李和甫	父亲
郭跃	郭向生	父亲
爱新觉罗-弘时	爱新觉罗-胤禛	父亲
爱德华-斯诺登	朗尼-斯诺登	父亲
杨澄甫	杨健侯	父亲
卢克-德容	乔治-德容	父亲
清高宗婉贵妃	陈延璋	父亲
嵩祝	岱衮	父亲
孙志浩	孙文骐	父亲
孔祥熙	孔繁慈	父亲
大祚荣	乞乞仲象	父亲
陈钦鹏	陈进贤	父亲
盖瑞-塞贝	凯斯-西贝利厄斯	父亲
居鲁士大帝	冈比西斯一世	父亲
梧桐妹	孙志浩	父亲
王泉仁	王文洋	父亲
夏小波	夏克俭	父亲
李少军	李光军	父亲
叱干谨	叱干辩	父亲
李莲英	李玉	父亲
林家川	林和平	父亲
察八儿	窝阔台汗	父亲
马希崇	马殷	父亲
爱新觉罗·弘昐	爱新觉罗·胤禛	父亲
卢西娅-普恩佐	路易斯-普恩佐	父亲
布伦特·巴里	里克·巴里	父亲
阿喇纳	阿南达	父亲
袁克捷	袁世凯	父亲
伊万诺维奇	拉德-伊万诺维奇	父亲
蜀汉敬哀皇后	张飞	父亲
菲莉娅尔公主	法鲁克	父亲
乐浪公主	王建	父亲
克里斯蒂安-马尔蒂尼	保罗-马尔蒂尼	父亲
黄兆熊	黄永年	父亲
戎祥	戎绍鑫	父亲
黎磊石	黎溥棠	父亲
熊大缜	熊正琦	父亲
杨文林	杨仁和	父亲
王才运	王睿谟	父亲
温井总贞	温井孝宗	父亲
唐中宗	唐高宗	父亲
汤珈铖	汤君年	父亲
林平之	林震南	父亲
宋世荣	宋嘉宾	父亲
维罗·史密斯	威尔·史密斯	父亲
凯文-加内特	奥-刘易斯-加内特	父亲
法图麦·李	李咏	父亲
陈国强	陈鹏权	父亲
华表	华歆	父亲
阿塔海	卜花	父亲
吴健雄	吴仲裔	父亲
许榕真	许承先	父亲
甄子丹	甄云龙	父亲
尹卓	尹明亮	父亲
寻阳公主	刘义隆	父亲
赵构	赵佶	父亲
连战	连震东	父亲
尼尔·布什	乔治·赫伯特·沃克·布什	父亲
夏侯湛	夏侯庄	父亲
惠恭皇后	王藻	父亲
陈五云	陈宝云	父亲
石中玉	石清	父亲
夏侯子臧	夏侯惇	父亲
王世霞	王丽卿	父亲
袁和平	袁小田	父亲
华严	严琥	父亲
布伦特·巴里	里克·巴里	父亲
刘山永	刘衡如	父亲
戴名扬	戴荣华	父亲
孙亦梁	孙瑞芹	父亲
伊万卡·特朗普	唐纳德·特朗普	父亲
赵玉明	赵松山	父亲
郭文珺	郭京生	父亲
周令飞	周海婴	父亲
马鸿逵	马福祥	父亲
郭雪姣	郭千文	父亲
孙娫	孙中山	父亲
姬昌	季历	父亲
尚平	尚贵臣	父亲
张孝杰	张俭	父亲
布兰登-弗雷泽	Peter Fraser	父亲
王赓武	王宓文	父亲
格伦-罗宾森	克里斯蒂安??布里奇曼	父亲
赵祯	赵恒	父亲
种谔	种世衡	父亲
乔治·凯西	老乔治·凯西	父亲
陈玲玲	岳琪	父亲
袁阔成	袁杰武	父亲
陈晓农	陈伯达	父亲
罗杰-费德勒	罗伯特-费德勒	父亲
杨涛	杨丙祥	父亲
尹卓林	尹柄正	父亲
康子林	康登明	父亲
周洪武	周瑛鹏	父亲
弗兰克-迪兰	斯蒂芬-迪兰	父亲
切斯-克劳福	Chris Crawford	父亲
朱孟炬	朱桢	父亲
老舍	舒永寿	父亲
爱新觉罗·多尔衮	努尔哈赤	父亲
李清娥	李胜哲	父亲
郭海长	郭仲隗	父亲
汉和帝	汉章帝	父亲
王金声	王锡庆	父亲
曹彦约	曹兴宗	父亲
李砚秀	李顺来	父亲
南康公主	明太祖朱元璋	父亲
李安琦	李小平	父亲
范文澜	范寿钟	父亲
哈罗德一世	克努特一世	父亲
陈业兴	陈金生	父亲
苏蕊娥	苏哲民	父亲
陶哲轩	陶象国	父亲
小劳勃·道尼	老罗伯特·唐尼	父亲
邵洪明	邵云儒	父亲
杜巨澜	王运熙	父亲
徐渭	徐鏓	父亲
冯自由	冯镜如	父亲
曾治豪	贺一航	父亲
蜜雪儿·摩纳汉	鲍伯·莫娜汉	父亲
藤井重郎	盐谷孙右卫门	父亲
田连章	田起山	父亲
孙翊茜	孙志浩	父亲
张以成	张大中	父亲
埃罗尔-弗林	西奥多-汤姆森-弗林	父亲
小昭	银叶先生	父亲
杨班侯	杨露禅	父亲
金正日	金日成	父亲
汉更始帝	刘子张	父亲
宋鸿远	宋淑光	父亲
瞿秋白	瞿世玮	父亲
朱棣	朱元璋	父亲
乔治·戈登·拜伦	约翰·拜伦	父亲
宣统	爱新觉罗·载沣	父亲
林俊红	林勇	父亲
刘振华	刘承占	父亲
庾峻	庾道	父亲
王贞仪	王锡琛	父亲
杨拯贵	杨虎城	父亲
陆贞	陆谦	父亲
宋霭龄	宋嘉树	父亲
刘永好	刘大镛	父亲
吴三桂	吴襄	父亲
寻阁劝	异牟寻	父亲
宋彬彬	宋任穷	父亲
翟爱云	翟彦生	父亲
朱家骅	云舫	父亲
吉田沙保里	吉田荣胜	父亲
恩里克-弗洛雷斯	伊希德罗-桑切斯	父亲
金平日	金日成	父亲
阎明复	阎宝航	父亲
孝哀皇后	傅宴	父亲
孝仪纯皇后	清泰	父亲
施桂林	施松福	父亲
钱钟书	钱基博	父亲
李新杰	李文田	父亲
希帕提娅	席昂	父亲
埃罗-沙里宁	G-E-沙里宁	父亲
米安·穆罕默德·纳瓦兹·谢里夫	米安·穆罕默德·谢里夫	父亲
白玉堂	毕善福	父亲
陈致中	陈水扁	父亲
斯蒂芬妮公主	兰尼埃三世	父亲
李宗伟	李亚财	父亲
莱因哈特·海德里希	布鲁诺	父亲
萧顺之	萧道赐	父亲
陈登恪	陈散原	父亲
邝野	邝子辅	父亲
克雷格-大卫	George David	父亲
小山田信茂	小山田信有	父亲
梅根-麦凯恩	约翰-麦凯恩	父亲
狐偃	狐突	父亲
卢克-沃顿	比尔-沃尔顿	父亲
宋襄公	宋桓公	父亲
奚爱华	奚东山	父亲
金达莱·萨法日尼	穆斯塔法·萨法日尼	父亲
周双健	周学谦	父亲
乔治·亚历山大·路易斯	威廉王子	父亲
齐文姜	齐僖公	父亲
玛丽埃拉-卡斯特罗	劳尔-卡斯特罗	父亲
周平珖	周企何	父亲
筱文滨	张少卿	父亲
韩王安	韩桓惠王	父亲
水亦诗	水均益	父亲
伊瓜因	豪尔赫-伊瓜因	父亲
何顺信	何福泉	父亲
李继春	李小春	父亲
平阳公主	李渊	父亲
李丽质	唐太宗李世民	父亲
刘金山	刘文光	父亲
任恩跃	任以礼	父亲
爱新觉罗-永璐	乾隆皇帝	父亲
黄乃	黄兴	父亲
李小强	李强	父亲
安德鲁·约翰逊	雅各布·约翰逊	父亲
林增平	林道一	父亲
孛儿只斤·忙哥剌	孛儿只斤·忽必烈	父亲
傅弘之	傅韶	父亲
朱见济	朱祁钰	父亲
诺拉-琼斯	拉维-香卡	父亲
贾斯汀-汀布莱克	Randy Timberlake	父亲
王思义	王圻	父亲
王明贞	王季同	父亲
窦凤琴	窦富民	父亲
李敖	李戡	父亲
李迥	唐代宗李豫	父亲
张学海	张君秋	父亲
香川照之	市川猿之助	父亲
宋子安	宋嘉树	父亲
王凤	王龙兴	父亲
吴天昊	吴晓波	父亲
何基沣	何士杰	父亲
赵雍	赵孟頫	父亲
饶平如	饶孝谦	父亲
鲁伯特-默多克	基思-默多克	父亲
王峰	王道军	父亲
浦安修	浦友梧	父亲
郭洪涛	郭志国	父亲
李德明	李继迁	父亲
玛丽昂-歌迪亚	Jean-Claude Cotillard	父亲
少昊	黄帝	父亲
陈海量	陈复初	父亲
惠福帝姬	宋徽宗	父亲
刘沉香	刘彦昌	父亲
陈瑞祺	陈澄波	父亲
丁晨元	丁震春	父亲
傅定谟	傅增湘	父亲
丁传靖	丁立干	父亲
几松	木崎市兵卫本	父亲
元太宗	成吉思汗	父亲
罗密欧-贝克汉姆	大卫-贝克汉姆	父亲
李任毕	李继松	父亲
潘汉年	潘莘臣	父亲
孙国良	孙柏龄	父亲
陈小虬	陈泰龙	父亲
岛津义弘	岛津贵久	父亲
贾科莫-卡萨诺瓦	盖塔诺-吉塞佩-卡萨诺瓦	父亲
杨敏德	杨元龙	父亲
张芷荃	张云亭	父亲
李云峰	李万堂	父亲
卢毓	卢植	父亲
大禹	鲧	父亲
德川家光	德川秀忠	父亲
邓傅密	邓石如	父亲
范时绎	范承勋	父亲
曹奂	曹宇	父亲
殷张兰熙	张承槱	父亲
李道宗	李韶	父亲
李健吾	李岐山	父亲
林立果	林彪	父亲
刘克庄	刘弥正	父亲
霍中曦	霍启刚	父亲
赵惠	赵建国	父亲
毛岸红	毛泽东	父亲
格温妮斯-帕特洛	布鲁-帕特洛	父亲
万瑞兴	万京麟	父亲
米歇尔	莱理-威廉姆斯	父亲
荀令文	荀慧生	父亲
王家飞	王廷礼	父亲
柳传志	柳谷书	父亲
胡钟吾	胡学汤	父亲
曹晖	曹德旺	父亲
福井谦一	福井亮吉	父亲
孔海珠	孔另境	父亲
邓英淘	邓力群	父亲
梅葆琛	梅兰芳	父亲
陈玉莲	陈宝善	父亲
陈新华	陈云	父亲
贾丹兵	贾建轩	父亲
阿尔法	阿尔斯兰	父亲
李元轨	李渊	父亲
孙壾	孙休	父亲
坂井悠二	坂井千草	父亲
赵构皇后吴氏	吴近	父亲
陈巨来	陈渭渔	父亲
完颜宗尧	金太祖	父亲
格伦-罗宾森	克里斯蒂安布里奇曼	父亲
肖木元	肖兆松	父亲
黄妙珠	黄园淞	父亲
嘉道理	伊利·嘉道理	父亲
许鹿希	许德珩	父亲
侯逸凡	侯雪健	父亲
李福兆	李冠春	父亲
晋文公	晋献公	父亲
武修文	武三通	父亲
黄英贤	黄义生	父亲
聂风	聂人王	父亲
李嫱冰	李晓东	父亲
贺炳炎	贺学文	父亲
高峰三枝子	高峰筑風	父亲
李元晓	李渊	父亲
浣溪沙苏轼	苏洵	父亲
李小林	巴金	父亲
郗徽	郗烨	父亲
尹剑平	尹雁翎	父亲
腓特烈大帝	腓特烈-威廉一世	父亲
田北辰	田元灏	父亲
郦道元	郦范	父亲
林爱儿	林建岳	父亲
隋菲菲	隋福安	父亲
苏局仙	苏升卿	父亲
汪桂林	汪永泰	父亲
南希·里根	肯家斯·罗宾斯	父亲
迈克尔·乔丹	詹姆斯·乔丹	父亲
袁涣	袁滂	父亲
迪肖恩-史蒂文森	达雷尔-史蒂文森	父亲
赵海仙	赵春普	父亲
王缉思	王力	父亲
明太祖朱元璋的大姐	朱世珍	父亲
陈婤	陈后主陈叔宝	父亲
廖克力	廖俊光	父亲
安娜-盖蒂	约翰-保罗-盖蒂	父亲
陈阅增	陈恕	父亲
大仲马	亚历山大·仲马	父亲
闫立品	闫彩云	父亲
楚灵王	楚共王	父亲
爱新觉罗-弘历	雍正皇帝	父亲
万仲翔	万里	父亲
蒋子丹	蒋牧良	父亲
赵曼琴	赵殿臣	父亲
琳赛-罗翰	迈克尔-洛翰	父亲
刘喜儿	刘小凤	父亲
祁世长	祁寯藻	父亲
黄子桓	黄百鸣	父亲
姚玉兰	姚长海	父亲
杨海润	杨子	父亲
藤泽一就	名誉棋圣藤泽秀行	父亲
杨文衡	杨振声	父亲
陈克威	陈仲卿	父亲
周旋	苏调夫	父亲
科比-布莱恩特	乔-布莱恩特	父亲
术赤	元太祖	父亲
李灵夔	李渊	父亲
陈见飞	陈泽民	父亲
王庭芳	王昌彬	父亲
林则徐	林宾日	父亲
安德雷-阿尤	阿贝迪-贝利	父亲
李忠	李治	父亲
丛兆桓	丛贯一	父亲
杨兵	杨天宏	父亲
加山雄三	上原谦	父亲
斯科特·卡彭特	马里昂斯·科特·卡彭特	父亲
关小鹏	关大鹏	父亲
乐安公主	明光宗朱常洛	父亲
英达	英若诚	父亲
莫林弟	顾云奎	父亲
红孩儿	牛魔王	父亲
宇文成都	宇文化及	父亲
赵丹	赵子超	父亲
陈晶	李志浩	父亲
曹徽	曹操	父亲
麦哲伦	路易·德·麦哲伦	父亲
卡拉卡拉	塞普提米乌斯-塞维鲁	父亲
王冀	王树常	父亲
颍阴长公主	汉桓帝	父亲
默罕默德·卡扎菲	卡扎菲	父亲
贺兰敏之	贺兰越石	父亲
安德洛尼卡三世	米海尔九世	父亲
蔡和森	蔡博	父亲
傅冬菊	傅作义	父亲
刘小英	刘英	父亲
伊丽莎白·福特	福特	父亲
齐啸云	齐协民	父亲
帕森斯	加里-帕森斯	父亲
杜维宁	杜月笙	父亲
丁建中	丁正洪	父亲
拉克兰-默多克	默多克	父亲
法兰·仙纳杜拉	安东尼·马田·西纳特拉	父亲
珊卓·布拉克	约翰·布拉克	父亲
苏莱曼一世	谢利姆一世	父亲
孙穗芬	孙科	父亲
李奉三	李大钊	父亲
耿冰娃	耿华	父亲
丹-布朗	查理-G-布朗	父亲
若热-贵诺	爱德华多-贵诺	父亲
李东东	李庄	父亲
莫天赐	莫理士	父亲
蒋纯寅	蒋纲	父亲
王冰玉	王大军	父亲
廖运泽	廖鸿文	父亲
李沅芷	李可秀	父亲
聂宪藩	聂士成	父亲
丹-艾克罗伊德	Peter	父亲
潘文复	潘庸秉	父亲
韦皇后	韦玄贞	父亲
本杰明-富兰克林	乔赛亚-富兰克林	父亲
黄硕	黄承彦	父亲
刘欢缘	刘保金	父亲
方玄初	方树东	父亲
王偃	王嘏	父亲
金达莱-萨法日尼	穆斯塔法-萨法日尼	父亲
越路吹雪	河野友孝	父亲
吉安娜-普罗德摩尔	迪林-普罗德摩尔	父亲
陶阳	陶国平	父亲
何爱喻	何甘棠	父亲
诗琳通公主	普密蓬·阿杜德	父亲
卢恬儿	卢润森	父亲
韩康子	韩庄子	父亲
邓洪山	邓九星	父亲
林建岳	林百欣	父亲
唐顺宗	唐德宗	父亲
宋高宗	宋徽宗	父亲
酒井忠次	酒井忠亲	父亲
李国豪	李小龙	父亲
达里安-莫格莱尼	亚历山德罗斯-莫格莱尼	父亲
明穆宗	明世宗	父亲
严凤英	严司明	父亲
路易-斐迪南	威廉皇储	父亲
陈志林	陈祖玲	父亲
梅西	豪尔赫	父亲
梁再冰	梁思成	父亲
本庄繁	本庄常右卫门	父亲
西汉前少帝	汉惠帝刘盈	父亲
连震东	连横	父亲
袁甲三	袁耀东	父亲
伯特兰-皮卡德	雅克-皮卡德	父亲
叶小纲	叶纯之	父亲
崇宁公主	明太祖朱元璋	父亲
赵匡胤	赵弘殷	父亲
方琼	方琳	父亲
李玉芙	李妙兰	父亲
迪丽娜尔·阿布都拉	阿布都拉	父亲
海姆达尔	奥丁	父亲
陈东海	陈明	父亲
太平公主	李治	父亲
杨隆	杨行密	父亲
罗德丞	罗文锦	父亲
土登嘉措	贡噶仁钦	父亲
索菲娅	法卢克-尤索夫	父亲
李庆容	李辅	父亲
安吉丽娜-茱莉	乔恩-沃伊特	父亲
史剑	史站立	父亲
郭念云	郭暧	父亲
乾隆帝	陈世倌	父亲
高城沙耶	高城壮一郎	父亲
陶龙春	陶玉芝	父亲
何宁	何贤省	父亲
刘曾复	刘诒孙	父亲
恩里克·伊格莱西亚斯	胡里奥·伊格莱西亚斯	父亲
侯谢	张黎明	父亲
克里斯蒂亚诺·罗纳尔多·多斯桑托斯	克里斯蒂亚诺·罗纳尔多	父亲
玛瑞丝卡·哈吉塔	麦琪-哈吉塔	父亲
周采芹	周信芳	父亲
靓元亨	李广勤	父亲
松田龙平	松田优作	父亲
冯今松	冯绪仁	父亲
迪迪埃-德库安	亨利德库安	父亲
辜朝明	辜宽敏	父亲
萧长华	萧永康	父亲
怀恩	戴希文	父亲
小罗伯特-唐尼	罗伯特-唐尼	父亲
蒋祖慧	冯达	父亲
阿卜杜拉-本-侯赛因	侯赛因	父亲
张雁全	张友烈	父亲
昂山素季	昂山	父亲
谢琰	谢安	父亲
温斯顿-丘吉尔	伦道夫-邱吉尔	父亲
谢侠逊	谢公出	父亲
哈桑-鲁哈尼	阿萨多拉-鲁哈尼	父亲
姚佩霞	姚席珍	父亲
江石溪	江振鑫	父亲
布兰登-费雪	彼得-弗雷泽	父亲
贯涌	贯大元	父亲
冯真	冯乃超	父亲
林文庆	林天尧	父亲
明节皇后	刘宗元	父亲
鸠摩罗什	鸠摩罗炎	父亲
陈永明	陈振先	父亲
哈国兴	哈攀龙	父亲
沈冰山	沈用三	父亲
李孝恭	李安	父亲
罗雪娟	罗国安	父亲
临川公主	李世民	父亲
王凝之	王羲之	父亲
麦克-波拉科夫斯	尼可莱	父亲
常宝霆	常连安	父亲
吕雉	吕文	父亲
约翰·肯尼迪	约瑟夫·肯尼迪	父亲
梁政珏	梁卫民	父亲
李健熙	李秉哲	父亲
庞伟	庞彦宏	父亲
竹下登	竹下勇造	父亲
纹锦	蜀桑子	父亲
吉默·弗雷德特	艾尔·弗雷迪特	父亲
乔纳森-利特尔	罗伯特-利特尔	父亲
司马模	司马泰	父亲
周国桢	周万龙	父亲
叶忠定	叶庭科	父亲
陈维蕊	陈树德	父亲
侯伯宇	侯镜如	父亲
巴克纳	老西蒙-玻利瓦尔-巴克纳	父亲
张末	张艺谋	父亲
瞿镛	瞿绍基	父亲
周均时	周汇三	父亲
李大海	李诚儒	父亲
陆志强	陆天泽	父亲
严凯泰	严庆龄	父亲
李元昌	李渊	父亲
王丽云	王裕民	父亲
夏菊花	徐造钱	父亲
姚俊良	姚巨货	父亲
清河公主	景昭帝	父亲
张锦	张鸣歧	父亲
杨绛	杨荫杭	父亲
龚半伦	龚自珍	父亲
韦唯	张玉	父亲
孝圣宪皇后	钮祜禄凌柱	父亲
高翔钰	高森林	父亲
尹博林	尹柄正	父亲
高安公主	唐高宗李治	父亲
梁欢	范荣康	父亲
陶弘景	陶贞宝	父亲
李应生	李紫石	父亲
山内溥	山内鹿之丞	父亲
哈里王子	查尔斯王储	父亲
王禹心	王仁甫	父亲
李墉	李暄	父亲
博扬	科尔吉奇	父亲
刘玉盛	刘先进	父亲
合撒儿	也速该-巴特尔	父亲
周德山	“面茶周”	父亲
戴名世	戴硕	父亲
李沁梅	李治	父亲
曹春山	曹凤志	父亲
罗莎娜	世界著名的音乐家克里斯-蒂伯	父亲
王石	王宁	父亲
吴俊东	吴秀芝	父亲
孝惠皇后	邵林	父亲
杜尔科	Estanislao	父亲
安乐公主	李显	父亲
林巧稚	林良英	父亲
朱徽妍	明光宗朱常洛	父亲
陈衷瑜	陈显	父亲
刘长瑜	周大文	父亲
沮渠牧健	沮渠蒙逊	父亲
刘永言	刘大镛	父亲
朱尼尔	克鲁格	父亲
关之琳	关山	父亲
邓丽君	邓枢	父亲
梁守槃	梁敬錞	父亲
曹怡	曹曾祥	父亲
史撷咏	史惟亮	父亲
郭灿	郭朴	父亲
李志民	李庆文	父亲
吴昌硕	吴辛甲	父亲
伍云召	伍建章	父亲
爱新觉罗·胤禄	康熙	父亲
潘鼎新	潘月樵	父亲
武顺	武士彠	父亲
瓢太	美央市道馆馆主	父亲
贝-布托	阿里-布托	父亲
黄彭年	黄辅辰	父亲
刘表	刘琮	父亲
成汉国	成池铉	父亲
杨恬	杨丕显	父亲
蜜雪儿-摩纳汉	鲍伯-莫娜汉	父亲
王定烈	王乐道	父亲
朱执信	朱启连	父亲
韩云飞	韩兆凯	父亲
坂本龙马	坂本八平	父亲
陈鸣远	陈子畦	父亲
胡奋	胡遵	父亲
张楚楚	张学津	父亲
韩献子	韩舆	父亲
马增锟	马连登	父亲
卓一龙	卓绵成	父亲
君士坦提乌斯一世	优特罗庇乌斯	父亲
黄均	黄彦鸿	父亲
于道泉	于明信	父亲
蹇先任	蹇承宴	父亲
迈克尔-布拉德利	鲍勃-布拉德利	父亲
塔玛拉·艾可莱斯顿	伯尼·艾可莱斯顿	父亲
亚森-罗宾	泰奥弗拉斯特-罗平	父亲
东晋豫州刺史	谢裒	父亲
郭正发	郭少亭	父亲
黄若	黄英森	父亲
刘跃云	刘纶	父亲
田震	田振华	父亲
爱新觉罗·永琮	爱新觉罗·弘历	父亲
阿敏·马卢夫	鲁查迪·马卢夫	父亲
布鲁诺·阿尔维斯	华盛顿·阿尔维斯	父亲
潘楚颖	潘迪生	父亲
颜鸣皋	颜余庆	父亲
谢道韫	谢奕	父亲
亚历山大三世	亚历山大二世	父亲
王丽芳	王实贵	父亲
唐代宗第五女	唐代宗	父亲
韩子高	韩延庆	父亲
小毛贲	王振元	父亲
珊莎-史塔克	艾德-史塔克	父亲
常贵德	常宝霆	父亲
陈伟兰	陈云	父亲
胡葆琳	胡靖安	父亲
孙楠	孙殿福	父亲
江小鹤	江志升	父亲
王思聪	王健林	父亲
陈云凤	陈嘉言	父亲
赵伟	赵庭富	父亲
樊景泰	樊得玉	父亲
唐朝霞	唐永良	父亲
汤姆-洛根	梅尔文-汤姆	父亲
金友祥	金好平	父亲
彭历生	彭畏三	父亲
乐浪公主	王建	父亲
赫尔曼-莫里斯-萨克斯伯爵	奥古斯特二世	父亲
邓彪	邓邯	父亲
埃玛-汤普森	埃里克-汤普森	父亲
王子涵	王晶	父亲
罗宝文	罗旭瑞	父亲
尼堪	褚英	父亲
伍廷芳	伍荣彰	父亲
桦山资纪	桥口与三次	父亲
高国华	高逸鸿	父亲
斛律皇后	斛律光	父亲
杨宗保	杨六郎	父亲
伯特兰·罗素	安伯雷子爵	父亲
燕桓侯	燕宣侯	父亲
赵匡胤	宋宣祖	父亲
蔡依林	蔡柱陈	父亲
章子男	章元孝	父亲
李颖	李治阳	父亲
李仲芳	李养心	父亲
焦秀兰	大金牙	父亲
羽濑川小鸠	羽濑川隼人	父亲
赵玉田	赵四	父亲
哈迪斯	克洛诺斯	父亲
斯特拉托妮可二世	安条克一世	父亲
倪瓒	倪炳	父亲
和硕和嘉公主	乾隆皇帝	父亲
张金梁	张春彦	父亲
柳德米拉-普京娜	亚历山大-A-什克列布涅夫	父亲
威廉-梅克比斯-萨克莱	李奇蒙-萨克雷	父亲
陶孟	陶仲明	父亲
陈国庆	陈嘉庚	父亲
爱新觉罗-胤礻我	康熙帝	父亲
吕凤鸣	吕茂权	父亲
布斯克茨	卡莱斯-布斯克茨	父亲
昭德皇后	王遇	父亲
陈玉莲	陈宝善	父亲
拓跋弗	拓跋沙漠汗	父亲
松田翔太	松田优作	父亲
吴尊	吴景添	父亲
颜杲卿	颜元孙	父亲
孙悟天	孙悟空	父亲
今川氏亲	今川义忠	父亲
约翰·卢卡斯	约翰·卢卡斯二世	父亲
王昌虎	王乃水	父亲
张旭云	张世学	父亲
林华国	林梦飞	父亲
周云亮	周振海	父亲
爱新觉罗·永璜	爱新觉罗·弘历	父亲
阿尔伯特亲王	萨克森	父亲
胡夏	胡宁	父亲
张延赏	张嘉贞	父亲
郑杰	郑树森	父亲
黄博文	黄俊伟	父亲
莱蒂齐亚	贝内代托-莱蒂齐亚	父亲
高凤仪	老南平王	父亲
司马攸	司马昭	父亲
沙马·顺达卫	沙勉·顺达叻威	父亲
比利-乔-阿姆斯特朗	Andy Armstrong	父亲
李昭	李仲侯	父亲
王永在	王长庚	父亲
邵醉翁	邵玉轩	父亲
田承嗣	田守义	父亲
乔纳森-利特尔	罗伯特??利特尔	父亲
麦考利·克金	克里斯多弗·卡尔金	父亲
黛咪-洛瓦特	柏德烈-洛瓦特	父亲
王佳俊	王峥嵘	父亲
英若聪	英骥良	父亲
吴浩	吴玉富	父亲
法拉利·恩佐	阿勒法多	父亲
严英云	严正方	父亲
罗布-福特	老德格-福特	父亲
刘旺	刘绍平	父亲
邱伟隆	邱明渊	父亲
张豪瑞	张明良	父亲
乔丹·斯科特	雷德利·斯科特	父亲
方少泉	方宝泉	父亲
奥巴马	巴拉克-侯赛因-奥巴马一世	父亲
钟生溢	钟炳昌	父亲
李鸿禧	李长庚	父亲
冯平山	冯洪福	父亲
宋奕萱	宋锋	父亲
泽纳妮·曼德拉·德拉米尼	曼德拉	父亲
陈盛桐	陈羽凡	父亲
柳乾	柳建辉	父亲
李恪	李世民	父亲
徐方正	徐时亮	父亲
陈松龄	陈富瑞	父亲
李可	李茂勋	父亲
李毅士	李宝章	父亲
曹上	曹操	父亲
许寿裳	许东辉	父亲
萧金臣	萧伏山	父亲
刘建康	刘振奇	父亲
甄子丹	甄云龙	父亲
泰坦	乌拉诺斯	父亲
邓碧孙	邓碧珊	父亲
苏武	苏建	父亲
刘贺	刘髆	父亲
沈亨业	沈泽河	父亲
艾米·雷德福	罗伯特·雷德福	父亲
韩厘王	韩襄王	父亲
菲德尔-卡斯特罗	安赫尔-卡斯特罗	父亲
吴作人	吴调元	父亲
詹姆士一世	亨利-斯图亚特	父亲
石华善	石廷柱	父亲
易宇爽	易耀彩	父亲
高雅之	高素	父亲
梁羽生	陈信玉	父亲
慕容纳	慕容皝	父亲
王威暘	王义夫	父亲
郑信	郑镛	父亲
王韦文	王庆春	父亲
陈景和	陈振声	父亲
张猛	张云田	父亲
阿兰-梅昂	弗兰西斯-梅昂	父亲
孙天牧	孙墨佛	父亲
爱新觉罗-代善	爱新觉罗-努尔哈赤	父亲
温青青	金蛇郎君	父亲
林志颖	林德雄	父亲
额哲	林丹汗	父亲
平阳公主	拓跋濬	父亲
任龙云	任忠明	父亲
赵武	赵朔	父亲
乔玉泉	乔蕙兰	父亲
黑泽明	黑泽勇	父亲
张彦远	张文规	父亲
赉塔	康古里	父亲
董建平	董浩云	父亲
周仲博	周凯亭	父亲
孙清香	孙彩兰	父亲
蔡文姬	蔡邕	父亲
方展博	方进新	父亲
陈泽民	陈邦平	父亲
贾里德	萨切萨林格	父亲
巴禄	班第	父亲
李根源	李大茂	父亲
舞阳公主	汉顺帝	父亲
詹姆士一世	亨利·斯图亚特	父亲
罗纳德·里根	约翰·杰克·里根	父亲
长乐郡公主	汉献帝	父亲
李美芝	李国泰	父亲
法兰-仙纳杜拉	安东尼-马田-西纳特拉	父亲
汪平孙	汪小亭	父亲
方铿	方肇周	父亲
廖廷君	廖百威	父亲
贾似道	贾涉	父亲
罗东进	罗荣桓	父亲
王广庆	王子亮	父亲
浦洁修	浦友梧	父亲
沈妙容	沈法深	父亲
韦恩-格雷茨基	沃尔特-格雷茨基	父亲
西尔莎-罗南	保罗-罗南	父亲
崔重华	崔泓熙	父亲
王元泽	王安石	父亲
解丰鸣	解植坤	父亲
卡洛尔-伦巴德	冯检基长彼得斯	父亲
王安忆	王啸平	父亲
郭侃峰	郭少安	父亲
卜峻超	卜兆麟	父亲
李小琳	李鹏	父亲
丹尼斯·加博尔	伯塔兰·加博尔	父亲
伏明霞	伏宜君	父亲
吴文明	吴启瑞	父亲
苗丰强	苗育秀	父亲
任志强	任建新	父亲
王承	王湛	父亲
元恪	元宏	父亲
杨义	杨少华	父亲
安德鲁-约翰逊	雅各布-约翰逊	父亲
娥皇	帝尧	父亲
刘志明	刘国忠	父亲
萧纶	萧衍	父亲
干露露	干爸爸	父亲
丁贵仁	丁飞远	父亲
刘义宣	刘裕	父亲
康熙	顺治	父亲
张筱贤	张月楼	父亲
曹二庚	曹心泉	父亲
文征明	文林	父亲
蔡依伦	蔡绿峰	父亲
蒙其-D-多拉格	蒙其-D-卡普	父亲
欧阳山尊	欧阳予倩	父亲
鄂邑盖长公主	汉武帝	父亲
亚瑟-叔本华	海因里希-弗洛里斯-叔本华	父亲
唐高宗	唐太宗	父亲
阎菁	阎明	父亲
苏克萨哈	苏纳	父亲
唐殇帝	李显	父亲
刘铸	刘和平	父亲
舒绣文	舒子胄	父亲
安陵容	安比槐	父亲
伊曼努尔·列维纳斯	叶茨耶尔·列维纳斯	父亲
玛丽埃拉·卡斯特罗	劳尔·卡斯特罗	父亲
河东公主	司马衷	父亲
侯外庐	侯福昌	父亲
李敏弟	李雅轩	父亲
织田信长	织田信秀	父亲
李安琪	李小平	父亲
若泽-拉莫斯-奥尔塔	萨拉查	父亲
姆波-普莱	曼德拉	父亲
张孝祥	张祁	父亲
吴佩孚	吴可成	父亲
邵洛羊	邵宝兴	父亲
俞大纯	黄敬	父亲
胡佳胤	胡迪红	父亲
秦怀玉	秦琼	父亲
陈政高	陈锡联	父亲
迈克尔·奥赫	丹尼斯·奥赫	父亲
南朝梁武帝女儿	梁武帝萧衍	父亲
苏蓬	苏雷	父亲
陈一鸣	陈鹤琴	父亲
曹茂	曹操	父亲
德川家康	广忠	父亲
杰西卡·拉德	陆克文	父亲
王喜姐	王伟	父亲
孙玉奎	孙寿斋	父亲
李贺	晋肃	父亲
魏孝文帝之女	拓跋宏	父亲
崔鸿	崔敬友	父亲
提奥多尔-艾克	海因里希-艾克	父亲
侯峻山	侯世昌	父亲
王菲	王佑林	父亲
林飞	林亨云	父亲
朱镕基	朱宽澍	父亲
苏曼殊	苏杰生	父亲
王僧绰	王昙首	父亲
艾薇儿	John Lavigne	父亲
崔子范	崔克庆	父亲
孙达成	孙敬贤	父亲
安吉丽娜-朱莉	乔恩-沃伊特	父亲
兹拉坦·伊布拉希莫维奇	efik	父亲
周洋	周继文	父亲
白寿彝	白吉甫	父亲
安妮-考克斯-钱伯斯	詹姆斯-M-考克斯	父亲
凯瑟琳-帕尔	托马斯-帕尔爵士	父亲
姜次郎	姜文	父亲
弘晖	雍正帝	父亲
张廷枢	张作相	父亲
冰心	谢葆璋	父亲
孛儿只斤·脱欢	孛儿只斤·忽必烈	父亲
杨世杭	杨培监	父亲
台静农	台佛岑	父亲
周瑞安	周春奎	父亲
高联奎	高士杰	父亲
何玉蓉	何颐馨	父亲
程民蕙	程万琦	父亲
巴金	李道河	父亲
安胜浩	安毅俊An eul jung	父亲
完颜襄	完颜阿鲁带	父亲
徐若愚	徐尔烈	父亲
皮特-桑普拉斯	山姆-桑普拉斯	父亲
本杰明-哈里森	约翰-斯科特-哈里森	父亲
室伏由佳	室伏重信	父亲
爱新觉罗-溥仪	载沣	父亲
周海泉	周青山	父亲
玛利·弗朗索瓦·萨迪·卡诺	伊波利特·卡诺	父亲
柯特妮·考克斯	理查德·L·考克斯	父亲
潘成豪	潘武卓	父亲
卢小嘉	卢永祥	父亲
唐群英	唐星照	父亲
林千钰	石英	父亲
汪小菲	汪则翰	父亲
王元禧	王葵芳	父亲
杨惠妍	杨国强	父亲
刘亭亭	刘少奇	父亲
八世达赖	索朗达结	父亲
王希坚	王翔千	父亲
陈佩斯	陈强	父亲
玛丽-路易丝	弗朗茨二世	父亲
米勒德-菲尔莫尔	撒尼尔-菲尔莫尔	父亲
贾维尔-麦基	乔治-蒙哥马利	父亲
宜里布	阿济格尼堪	父亲
朱瞻基	朱高炽	父亲
克里斯特尔斯	里奥	父亲
赵瑞花	赵厚均	父亲
戴晓霞	戴忍坚	父亲
杨奇	杨统	父亲
邹经	邹廷扬	父亲
马三立	马德禄	父亲
琳达-布朗	奥利弗-布朗	父亲
爱新觉罗·弘瞻	爱新觉罗·胤禛	父亲
方荣欣	方志纯	父亲
弘暾	胤祥	父亲
陈蒨	陈道谭	父亲
杰克逊	乔-杰克逊	父亲
崔世平	崔德祺	父亲
邓小岚	邓拓	父亲
克里斯蒂安-莫利纳罗	埃米里奥	父亲
刘德然	刘元起	父亲
哈克三	法萨里巴图鲁	父亲
李少军	李光军	父亲
李鹏	李硕勋	父亲
克里斯蒂娜·艾伯盖特	罗伯特·艾伯盖特	父亲
杜聿明	杜良奎	父亲
张巧霞	张学昆	父亲
洪元硕	洪谦	父亲
达莎朱可娃	Alexander Zhukova	父亲
叶准	叶问	父亲
李义铭	李焕章	父亲
缪言	陈永华	父亲
法兰克-辛纳屈	安东尼-马田-西纳特拉	父亲
黄奕	黄骏	父亲
帕斯捷尔纳克	列昂尼德-奥西波维奇-帕斯捷尔纳克	父亲
东乡平八郎	东乡吉左卫门	父亲
萧孟能	萧同兹	父亲
姜夔	姜噩	父亲
林纾	林国铨	父亲
李四光	李卓侯	父亲
弗兰克·劳埃德·赖特	WilliamCaryWright	父亲
哈文	哈金杰	父亲
杜均堂	杜笃之	父亲
张延培	张似云	父亲
金·阿里斯	阿里斯	父亲
贝纳多·贝托鲁奇	提立欧·贝托鲁奇	父亲
哈罗德-麦克米伦	莫里斯-克劳福德-麦克米伦	父亲
成龙	房道龙	父亲
蔡晨	蔡广生	父亲
Lea-T	塞雷佐	父亲
慕容宝	慕容垂	父亲
薛嵩	薛楚玉	父亲
伊莎贝尔·威尔逊	托尼·威尔逊	父亲
刘晓楠	刘天远	父亲
荀令香	荀慧生	父亲
张克莎	张书祥	父亲
弘文天皇	天智天皇	父亲
谷尚尉	谷祥弟	父亲
孔维益	孔德成	父亲
朱俊	朱庆林	父亲
何泽慧	何澄	父亲
丁素拉	丁汉荣	父亲
凉国公主	唐睿宗李旦	父亲
邓焘	邓焜	父亲
李光前	李国候	父亲
李敬	唐太宗李世民	父亲
冯慧兰	冯来金	父亲
肖凯	肖劲光	父亲
恩里克-莱塔	乔治-莱塔	父亲
徐亚凤	徐天梅力	父亲
林丹	林建斌	父亲
潘光渭	潘永玄	父亲
濮存昕	苏民	父亲
戴锡可	戴嘉树	父亲
丹尼斯-加博尔	伯塔兰-加博尔	父亲
谭邦杰	谭显章	父亲
孔德懋	孔令贻	父亲
田中真纪子	田中角荣	父亲
田慧棣	田萱	父亲
柄本时生	柄本明	父亲
杰拉德-巴特勒	爱德华-巴特勒	父亲
谭其骧	谭新润	父亲
埃德蒙·伦道夫	佩顿·伦道夫	父亲
尼基塔·米哈尔科夫	赛吉米亥科夫	父亲
高旭	高炜	父亲
金溥聪	金铄	父亲
雅克·勒内·希拉克	弗朗索瓦	父亲
李盛藻	李寿峰	父亲
李光弼	李楷洛	父亲
张茅	张劲夫	父亲
多米尼克-艾伯	杰克-艾伯	父亲
章子怡	章元孝	父亲
吴树根	吴振德	父亲
孙峻	孙恭	父亲
唐宪宗	唐顺宗	父亲
十三世达赖	贡噶仁钦	父亲
邢丹	邢振祥	父亲
吉利沃尔沃汽车集团李书福之女	吉利集团董事长李书福	父亲
陈小津	陈丕显	父亲
娜奥米-沃茨	Peter Watts	父亲
李流芳	李汝筠	父亲
冈田克也	冈田卓也	父亲
马西桂	马明道	父亲
王祥	王融	父亲
让-保罗-萨特	让-巴浦蒂斯特-萨特	父亲
戴福铸	戴国恒	父亲
柴绍	柴慎	父亲
宋宣公	宋武公	父亲
黎萱	黎民伟	父亲
雷振华	雷喜福	父亲
赵一荻	赵庆华	父亲
黄志刚	黄德辉	父亲
陈晨	陈仁杰	父亲
诸葛亮的妻子	黄承彦	父亲
司马敏	司马防	父亲
平城天皇	桓武天皇	父亲
王振澳	王海洋	父亲
刘伟尔	克劳德-约瑟夫·刘维尔	父亲
陶斯亮	陶铸	父亲
孙贵	孙翠凤	父亲
燕德妃	燕宝寿	父亲
亚曼达·拜恩斯	瑞克	父亲
吴尚新	吴春贵	父亲
徐美淘	徐京旭	父亲
妲己	苏护	父亲
程晓红	程元璋	父亲
王宁	王奎鑫	父亲
安妮-勃朗特	帕特里克-勃朗特	父亲
张克群	张维	父亲
贝尔塔·弗赖茹劳·冯·苏特纳	弗朗茨·麦克尔·金斯基	父亲
秦朗	秦宜禄	父亲
立花道雪	户次亲家	父亲
宋鱼水	宋世学	父亲
黑小虎	黑心虎	父亲
汤飞凡	汤麓泉	父亲
汪乃海	汪立德	父亲
爱新觉罗·永琪	爱新觉罗·弘历	父亲
王顼龄	王广心	父亲
罗嘉瑞	罗鹰石	父亲
郑幽公	郑共公	父亲
隆虑公主	汉明帝	父亲
列夫-尼古拉耶维奇-托尔斯泰	尼古拉-伊里奇	父亲
燕王喜	燕孝王	父亲
宣姜	齐僖公	父亲
武田胜赖	武田信玄	父亲
阿拉腾花	钢苏	父亲
努尔哈赤	塔克世	父亲
高剑父	高保样	父亲
程之	程君谋	父亲
林晓霖	林彪	父亲
李兆楠	李介甫	父亲
陈梓旭	陈贵华	父亲
马克斯·普朗克	威廉·约翰·尤利乌斯·普朗克	父亲
易顺鼎	易佩绅	父亲
英骥良	英敛之	父亲
黄小蓓	黄焕秋	父亲
多斯-桑托斯	济济尼奥	父亲
夏明翰	夏绍范	父亲
凯末尔	阿里-里札	父亲
辛·艾斯丁	约翰·奥斯汀	父亲
邓林	邓小平	父亲
顾谭	顾邵	父亲
毛超	毛小洲	父亲
孙玲珑	孙权	父亲
邱爱伦	邱秉敏	父亲
昂洪	明安	父亲
宋子良	宋嘉树	父亲
薛西斯一世	大流士一世	父亲
王冬新	王斗斌	父亲
巴切莱特	阿尔贝托·巴切莱特	父亲
齐长公主	魏明帝	父亲
何勇	何玉生	父亲
丹尼尔-巴林杰	丹尼尔-莫罗-巴林杰	父亲
贝娜齐尔·布托	佐勒菲卡尔·阿里·布托	父亲
安·海瑟薇	杰拉德·海瑟薇	父亲
古利娜拉·卡里莫娃	卡里莫夫	父亲
胡道静	胡怀琛	父亲
聂风	易风	父亲
毛远新	毛泽民	父亲
武崇训	武三思	父亲
赵季平	赵望云	父亲
春日局	明智光秀的家臣斋藤利三	父亲
胡志强	胡富国	父亲
李满柱	释家奴	父亲
海迪-汉金斯	马修	父亲
焦秀芸	大金牙	父亲
孙荣蕙	孙伯山	父亲
潘怀刚	潘祖周	父亲
玛丽一世	亨利八世	父亲
郑孝胥	郑守廉	父亲
刘西尧	刘秉勋	父亲
玻尔	克里斯丁-玻尔	父亲
孙翠凤	陈明吉	父亲
郭少衡	郭菊荪	父亲
陈鸿源	陈明雄	父亲
米海尔·亚历山德罗夫	普拉曼·亚历山德罗夫	父亲
安德鲁·克尼格	沃尔特·克尼格	父亲
耿世华	耿永峰	父亲
爱新觉罗·弘晓	爱新觉罗·胤祥	父亲
肇俊哲	肇新生	父亲
石保兴	石守信	父亲
腓特烈-威廉四世	腓特烈-威廉三世	父亲
史建瑭	史敬思	父亲
姬发	姬昌	父亲
明月不夜羽	鬼荒地狱变	父亲
南希·佩洛西	汤米·亚利桑德罗	父亲
玛莉丝卡·哈吉塔	MickeyHargitay	父亲
小毛剑秋	王椿柏	父亲
片仓重长	片仓景纲	父亲
王楠	王德占	父亲
秋冈荣子	秋冈家荣	父亲
蕉下客	贾政	父亲
姜珊	姜昆	父亲
莉萨-玛丽-普雷斯利	埃尔维斯-普雷斯利	父亲
叶刘淑仪	刘福成	父亲
马尔蒂·阿赫蒂萨里	奥伊瓦	父亲
卢克·德容	乔治·德容	父亲
伯特兰-罗素	安伯雷子爵	父亲
慕容涉归	慕容木延	父亲
周有光	周保贻	父亲
张超	张恩泰	父亲
王长庚	王永在	父亲
陈康	陈含光	父亲
程志	程启文	父亲
安德烈斯·帕斯特拉纳·阿朗戈	米萨埃尔·帕斯特拉纳·博雷罗	父亲
鲍春来	鲍长安	父亲
新安公主	简文帝司马昱	父亲
朱元璋	朱世珍	父亲
萧峰	萧远山	父亲
黄佳燕	黄涛	父亲
陆昌立	陆长林	父亲
郑灵公	郑穆公	父亲
秋岡秀治	平川幸男	父亲
林德华	林寿杲	父亲
须佐之男	伊邪那岐	父亲
赵青	赵丹	父亲
袁健进	袁志强	父亲
杨永晴	杨超成	父亲
刘霓娜	刘烨	父亲
俞大纯	俞明震	父亲
郭道晖	郭德垂	父亲
阿里-邦戈	哈吉-奥马尔-邦戈	父亲
尼古拉·普桑	让·普桑	父亲
爱新觉罗·永瑆	爱新觉罗·弘历	父亲
玖兰优姬	玖兰悠	父亲
许奇	许允因	父亲
刘璿	刘禅	父亲
鲍起静	鲍方	父亲
羽根直树	羽根泰正	父亲
龚克	龚育之	父亲
苏盛琴	苏雨卿	父亲
首藤刚志	首藤尧	父亲
殷浩	殷羡	父亲
胡文虎	胡子钦	父亲
徐建寅	徐寿	父亲
罗莎里奥-弗洛雷斯	安东尼奥-冈萨雷斯	父亲
陶宇佳	陶美阳	父亲
蕾哈娜	罗纳德·芬蒂	父亲
李良臣	李凤祥	父亲
马克·沃尔伯格	唐纳德	父亲
小王涛	王永全	父亲
培根	尼古拉	父亲
马畅	马国相	父亲
王征	盛毓南	父亲
兰斯-阿姆斯特朗	斯蒂芬-科尼-阿姆斯特朗	父亲
朱文英	朱小喜	父亲
陈寅恪	陈散原	父亲
李明堂	李东红	父亲
闻喜公主	汉和帝	父亲
和珅	钮祜禄-常保	父亲
吴晗	吴瑸珏	父亲
杨振声	杨文衡	父亲
高锟	高君湘	父亲
赵顺孙	赵雷	父亲
汪沁	汪平孙	父亲
李又兰	李善祥	父亲
卡米耶-毕沙罗	亚伯拉罕-加百列-毕沙罗	父亲
郭雪湖	郭忠贵	父亲
赫尔曼-威廉-戈林	海因里希-欧内斯特-戈林	父亲
黄用诹	黄式渔	父亲
莎拉·洁西卡·帕克	史蒂芬·帕克	父亲
莫文蔚	莫天赐	父亲
冯潇霆	冯军	父亲
曹芳	曹楷	父亲
小幡昌盛	小幡虎盛	父亲
凯瑟琳·海格尔	保罗·海格尔	父亲
杨化然	杨威	父亲
李虹	李歇浦	父亲
朱致格	朱宠涭	父亲
胡纪元	胡兰成	父亲
安德雷·阿尤	阿贝迪·贝利	父亲
黄仁宇	黄震白	父亲
萨木萨克	波罗尼都	父亲
章兰	章兆麟	父亲
彭家鹏	彭长华	父亲
沙伯略	沙尔汗	父亲
黄亚生	黄钢	父亲
别儿迪别汗	札尼别	父亲
车鼎晋	车万育	父亲
阿米尔·汗	TahirHussain	父亲
筱高雪樵	高月秋	父亲
胡蓉蓉	胡小元	父亲
于洪江	于林阁	父亲
曹髦	曹霖	父亲
骊山老母	雷神	父亲
许正民	许建奎	父亲
夏侯建	夏侯胜	父亲
毛泽东	毛顺生	父亲
拉里·佩奇	卡尔·佩奇	父亲
刘胜	汉景帝	父亲
朱圣琴	朱新礼	父亲
刘雄	刘豹	父亲
关栋天	关正明	父亲
王皓	王忠全	父亲
曹爽	曹真	父亲
阿里·邦戈	哈吉·奥马尔·邦戈	父亲
郑大进	郑养性	父亲
张猛	张惠中	父亲
王长林	王德忠	父亲
崇峻天皇	钦明天皇	父亲
张豪龙	张仁勇	父亲
慕容复	慕容博	父亲
邹志斌	邹长福	父亲
王慧炯	王补生	父亲
鲁思-克利夫兰	克利夫兰	父亲
渡边大	渡边谦	父亲
燕侯宪	燕侯舞	父亲
赵奢	赵武灵王	父亲
冠军公主	汉顺帝	父亲
罗志军	罗瑞卿	父亲
燕惠王	燕昭王	父亲
王若琳	王治平	父亲
钮钴禄·嘉嘉	钮祜禄·阿灵阿	父亲
严稚棱	严铮	父亲
丁建军	丁国锋	父亲
马相伯	马松岩	父亲
罗伯特-巴乔	弗奥林多	父亲
石鲁	冯子融	父亲
王丽萍	王凤栋	父亲
宣武顺皇后	于劲	父亲
许仕仁	许声泉	父亲
卢永强	卢鹤绂	父亲
奥利弗-克伦威尔	罗伯特-克伦威尔	父亲
尚大德	尚清	父亲
赵式明	赵世光	父亲
圣香	赵匡胤	父亲
姬延	姬定	父亲
李鸣岩	李连甲	父亲
罗温·艾金森	艾里克·艾金森	父亲
劳拉·德克尔	迪克·德克尔	父亲
徐君跃	徐匡华	父亲
楚原	张活游	父亲
高岳崧	高景清	父亲
刘映林	刘觉吾	父亲
马海龙	马岳梁	父亲
易立	易德华	父亲
唐美云	蒋武童	父亲
张元忭	张天复	父亲
明智光秀	明智光纲	父亲
范伟	范承业	父亲
蔡小汀	蔡鹤汀	父亲
刘云善	刘德华	父亲
米莉-塞勒斯	比利-雷-塞勒斯	父亲
大冢明夫	大冢周夫	父亲
阿道夫-威廉	威廉	父亲
杨惠	杨崇贤	父亲
慧贤皇贵妃	高斌	父亲
章立凡	章乃器	父亲
李渊	李建成	父亲
于素秋	于占元	父亲
高桥绍运	吉弘鉴理	父亲
苏盛贵	苏雨卿	父亲
常宝堃	常连安	父亲
马友友	马孝骏	父亲
范蔚菁	范国强	父亲
刘清韵	刘蕴堂	父亲
陈登	陈珪	父亲
格奥尔基-康斯坦丁诺维奇-朱可夫	康斯坦丁-安德烈耶维奇	父亲
程颐	程珦	父亲
刘胡兰	刘景谦	父亲
伊丽莎白·芭蕾特·布朗宁	爱德华·巴雷特	父亲
周梅森	周文虎	父亲
斯万特-奥古斯特-阿累尼乌斯	斯范特-古斯培夫	父亲
李国静	李良才	父亲
孝景皇后	王仲	父亲
贾琏	贾赦	父亲
威廉-佩利	萨姆-佩利	父亲
碧昂斯-诺里斯	Mathew Knowles	父亲
喻玲欢	喻明亮	父亲
李泳汉	李家鼎	父亲
张安妮	张林	父亲
依莉雅斯菲尔·冯·爱因兹贝伦	卫宫切嗣	父亲
曲乐恒	曲明书	父亲
文鸯	文钦	父亲
刘世臣	刘喜益	父亲
舒乙	老舍	父亲
王景福	王玉山	父亲
朱祁镇	朱瞻基	父亲
威廉-詹姆斯-席德斯	鲍里斯-席德斯	父亲
丛珊	丛兆桓	父亲
洪学智	洪金儒	父亲
李广田	王者经	父亲
佟麟阁	佟焕文	父亲
刘守光	刘仁恭	父亲
江绵恒	江泽民	父亲
陆景春	陆喜明	父亲
凌叔华	凌福彭	父亲
亚历山大-马洪	Edward	父亲
李尚大	李瑶悌	父亲
程克祥	程维藩	父亲
梅镇岳	蒋朝贵	父亲
麦考利-库尔金	克里斯多弗-卡尔金	父亲
宇文邕	宇文泰	父亲
婉贵妃	陈延璋	父亲
安希范	安如山	父亲
师洋	师小宁	父亲
尤恩·古尔库夫	克里斯蒂安·古尔库夫	父亲
彭小枫	彭雪枫	父亲
克伦威尔	罗伯特-克伦威尔	父亲
元春	贾政	父亲
谢尔盖·布林	迈克尔	父亲
邓牛顿	邓海涛	父亲
清河公主	景昭帝	父亲
陈颖	陈存贵	父亲
曹华	曹孟德	父亲
佛尼埒	索尔和诺	父亲
房陵公主	唐高祖李渊	父亲
傻姑	曲灵风	父亲
爱新觉罗·永璐	爱新觉罗·弘历	父亲
杨维聪	杨和	父亲
洪丕谟	洪吉求	父亲
薛己	薛铠	父亲
冯庸	冯德麟	父亲
文明太后	冯朗	父亲
关伯威	关世栋	父亲
萧盛萱	萧长华	父亲
沈琪	沈沂	父亲
王磊	王建国	父亲
爱新觉罗-弘历	爱新觉罗-胤禛	父亲
侯赛因·本·塔拉勒	塔拉勒·伊本·阿卜杜拉	父亲
贾马尔·桑普森	拉尔夫·桑普森	父亲
朱慈焕	朱由检	父亲
金启孮	金光平	父亲
姬介	姬仁	父亲
威廉-拉姆齐	老拉姆齐	父亲
高世泰	高庆奎	父亲
张舸	张毅	父亲
爱新觉罗-永珹	乾隆皇帝	父亲
韦恩·格雷茨基	沃尔特·格雷茨基	父亲
曹洪	曹瑜	父亲
安德烈·纪德	保尔·纪德	父亲
朱定煠	朱誉荣	父亲
吴君如	夏春秋	父亲
犬夜叉	斗牙王	父亲
陈知非	陈赓	父亲
威廉四世	乔治三世	父亲
赵飞	赵鸣深	父亲
李安妮	李登辉	父亲
内特-罗宾逊	杰克	父亲
邢文藻	邢景参	父亲
策楞	尹德	父亲
西耶娜-米勒	爱德华-米勒	父亲
王雪峰	王昆和	父亲
史静	史万岁	父亲
徐惠	徐孝德	父亲
蒋友青	蒋孝勇	父亲
复海大圣	北海龙王	父亲
斯坦-范甘迪	比尔-范甘迪	父亲
陈锡联	陈永厚	父亲
格雷贝桑	根噶札西	父亲
小蝶	孙玉伯	父亲
李耳	李乾	父亲
相马忠胤	土屋忠直	父亲
苏祖馨	苏明珍	父亲
黄一欧	黄兴	父亲
潘景晴	潘应祺	父亲
劳勃-瑞福	查尔斯-劳勃-瑞福	父亲
耿伯春	耿宝林	父亲
果素瑛	果湘林	父亲
楼适夷	楼宗鉴	父亲
郭以雅	郭晋安	父亲
张勇	张旭云	父亲
林楚麒	黄浩义	父亲
邵自强	邵全仁	父亲
克林特·伊斯特伍德	老克林特·伊斯特伍德	父亲
安定公主	李渊	父亲
献帝伏皇后	伏完	父亲
廖尧城	廖烈文	父亲
陈汉文	陈元正	父亲
霍启刚	霍震霆	父亲
顾德昌	顾维钧	父亲
列宁	伊里亚-尼古拉也维奇-乌里扬诺夫	父亲
许世勋	许爱周	父亲
杨利平	杨买昌	父亲
冈崎朋也	冈崎直幸	父亲
王文祥	王永庆	父亲
丹尼尔-韦斯特林	奥勒-韦斯特林	父亲
胡政尧	胡兵	父亲
吴慧光	吴炳树	父亲
黄绍箕	黄体芳	父亲
席蕙田	席居拱	父亲
李桂泉	李子美	父亲
爱新觉罗-弘瞻	雍正皇帝	父亲
吴幼坚	吴有恒	父亲
刘恺威	刘庆基	父亲
朱世乐	朱光潜	父亲
道格拉斯-麦克阿瑟	小阿瑟-麦克阿瑟	父亲
刘义符	刘裕	父亲
吉姆·沃尔顿	山姆·沃尔顿	父亲
爱新觉罗·皇太极	爱新觉罗·努尔哈赤	父亲
许份	许将	父亲
杰米-雷德克纳普	哈里-雷德克纳普	父亲
康有为	康达初	父亲
铁木儿	塔拉盖	父亲
冯绲	冯焕任	父亲
李特特	李富春	父亲
陈延熙	陈耕耘	父亲
马克·舒瓦泽	乔奇姆	父亲
隆科多	佟国维	父亲
巴尔图	杰书	父亲
爱新觉罗·弘昀	爱新觉罗·胤禛	父亲
辜濂松	辜岳甫	父亲
萧方等	萧绎	父亲
张学良	张作霖	父亲
郑欣宜	郑少秋	父亲
李怡	李化	父亲
濑川瑛子	濑川伸	父亲
朱高炽	朱棣	父亲
李宝櫆	李菊笙	父亲
昆汀-塔伦蒂诺	托尼-塔伦蒂诺	父亲
秋山好古	藩士秋山久敬	父亲
东条英机	东条英教	父亲
秦燕	史文帜	父亲
宋氏三姐妹	宋嘉树	父亲
吴满福	吴桂芬	父亲
钱德月	钱龙涛	父亲
周厚安	周华健	父亲
唐浩明	唐振楚	父亲
大金牙	焦永顺	父亲
苏铁山	苏进	父亲
西尔莎·罗南	保罗·罗南	父亲
丹尼尔-戴-刘易斯	Cecil Day-Lewis	父亲
朱征钋	朱范昂	父亲
傅益瑶	傅抱石	父亲
曹驰	曹锦荣	父亲
杨玉龙	杨金国	父亲
李继春	李小春	父亲
丁瑗	丁传靖	父亲
丽贝卡·米勒	亚瑟米勒	父亲
陈海涛	陈林	父亲
司马肜	司马懿	父亲
琳恩-切尼	韦恩-埃德温-文生	父亲
贾斯汀-汀伯雷克	Randy Timberlake	父亲
许其亮	许乐书	父亲
克林姆	恩斯特-克林姆	父亲
宇文娥英	宇文贇	父亲
谢金燕	猪哥亮	父亲
陈仁烈	陈崇桂	父亲
李膺	李益	父亲
稻叶一铁	稻叶通则	父亲
盛中国	盛雪	父亲
麦考利-克金	克里斯多弗-卡尔金	父亲
冯媛	冯奉世	父亲
傅作义	傅庆泰	父亲
张宝忠	张玉山	父亲
张博宇	张丰毅	父亲
安吉丽娜·朱莉	乔恩·沃伊特	父亲
钱三强	钱玄同	父亲
李国豪	李小龙	父亲
陈履安	陈诚	父亲
孔明珠	孔另境	父亲
司马冲	晋元帝司马睿	父亲
杨铁柱	杨盛春	父亲
郑晓丹	郑新潮	父亲
孙剑	孙玉伯	父亲
莫妮卡-贝鲁奇	Pasquale Bellucci	父亲
额尔德	塞勤	父亲
赵子云	赵玉峰	父亲
谢一岗	谢树英	父亲
王恩怀	王步	父亲
毛利兰	毛利小五郎	父亲
许连捷	许书典	父亲
丽贝卡-米勒	亚瑟米勒	父亲
友坂理惠	友坂信博	父亲
陆川	陆天明	父亲
刘爱兵	刘必方	父亲
林敏俐	林国光	父亲
曹彪	曹操	父亲
汪永清	汪东兴	父亲
萨弗伦	丹尼-普莱杰	父亲
何长工	何启源	父亲
徐林胤	武强	父亲
张鸣镛	张肇麟	父亲
汪机	汪渭	父亲
金熙宗之女	金熙宗完颜合刺	父亲
楚熊延	楚熊渠	父亲
张范	张延	父亲
陈发科	陈延熙	父亲
潘世建	潘懋元	父亲
张议潮	张谦逸	父亲
路易斯·加瑞尔	菲利普·加瑞尔	父亲
李嘉诚	李云经	父亲
黄艺博	黄宏章	父亲
丽莎·玛丽·普雷斯利	埃尔维斯·普雷斯利	父亲
阿莫德-哈默	朱利叶斯	父亲
张讥	张仲悦	父亲
科莫娃	亚历山大-科莫夫	父亲
韩介	韩超然	父亲
周循	周瑜	父亲
顾慰连	顾毓秀	父亲
孙墨佛	孙雨亭	父亲
葛莱史东	古斯塔夫-甘德	父亲
罗达伦	罗伯健	父亲
李松舟	李祥林	父亲
杨艳	杨炳	父亲
施小墨	施今墨	父亲
刘基	刘繇	父亲
晋秦州刺史胡烈之子	胡烈	父亲
王君直	王敬熙	父亲
何鸿燊	何世光	父亲
潘有声	潘永辉	父亲
鲁迪-朱利安尼	哈勒德-安卓-朱利安尼	父亲
阿部信行	金泽藩士	父亲
庄月明	庄静庵	父亲
华焯	华廷杰	父亲
东白	陈海桥	父亲
劳拉-布什	哈罗德-维尔奇	父亲
冯毅之	冯旭臣	父亲
务达海	穆尔哈齐	父亲
潘晓婷	潘健	父亲
济尔哈朗	爱新觉罗-舒尔哈齐	父亲
成衮紥布	策棱	父亲
刘光	刘广亦	父亲
岑春煊	岑毓英	父亲
斯各特	阿提克斯-芬奇	父亲
马鼎盛	马师曾	父亲
献明肃皇后	刘通	父亲
陆振忠	陆喜明	父亲
杨震	杨宝	父亲
李忠诚	李铁泰	父亲
谢飞	谢觉哉	父亲
切-格瓦拉	埃内斯托-格瓦拉-林奇	父亲
柏晶	柏成营	父亲
张爱玲	张志沂	父亲
文徵明	文林	父亲
比尔-盖茨	William H Gates	父亲
许崇岩	许继兴	父亲
铃木园子	铃木史郎	父亲
黄君璧	黄仰荀	父亲
尹北琛	尹国祥	父亲
徐墉	徐德霖	父亲
鲁伟鼎	鲁冠球	父亲
董建华	董浩云	父亲
施泰纳	尼克劳斯-施泰纳	父亲
倪震	倪匡	父亲
许海峰	许银芝	父亲
塔尔顿	约翰-塔尔顿	父亲
李长治	李泽楷	父亲
甄子菁	甄云龙	父亲
高坂桐乃	高坂大介	父亲
谭孝曾	谭元寿	父亲
李鸿源	李腾辉	父亲
陈乐宗	陈曾熙	父亲
张笃敬	张芝	父亲
谢振轩	谢霆锋	父亲
李妮娜	李雨	父亲
王茜	王宝泉	父亲
莫言	管贻凡	父亲
努尔王后	纳吉布·伊利亚斯·哈拉比	父亲
董贤	董恭	父亲
奥巴马	巴拉克·侯赛因·奥巴马一世	父亲
梁思懿	梁启超	父亲
石建农	石启贵	父亲
浣碧	甄远道	父亲
朱斌舫	朱小芬	父亲
马晶晶	马崇林	父亲
马德莱娜	卡尔十六世·古斯塔夫	父亲
徐仁铸	徐致靖	父亲
叶世长	叶春善	父亲
李启铭	李刚	父亲
谭玲	谭天生	父亲
莫惠栋	莫向荣	父亲
王基	王豹	父亲
李兆基	李介甫	父亲
陈晓丹	陈元	父亲
瑞恩·戴	凯文	父亲
马斯喀	米思翰	父亲
徐晓白	徐祖藩	父亲
卡布斯·本·赛义德	赛义德·本·泰姆尔	父亲
崇绮	赛尚阿	父亲
田秀英	田弘遇	父亲
沈葆桢	沈廷枫	父亲
李振华	李景唐	父亲
段宏业	段祺瑞	父亲
南阳公主	隋炀帝杨广	父亲
黄光业	黄锦燊	父亲
袁克友	袁世凯	父亲
夏尔丹	让-夏尔丹	父亲
伍步高	伍宜孙	父亲
王梓轩	王英伟	父亲
李重庵	李秉德	父亲
张志淳	张昺时	父亲
侯耀华	侯宝林	父亲
张治安	张家顺	父亲
张军	张正海	父亲
曾屿	曾海宽	父亲
李顺圭	李洙英	父亲
季文子	孟献子	父亲
姜文焕	姜桓楚	父亲
山川健次郎	固体山川茂	父亲
何芳川	何兹全	父亲
张宗宪	张仲英	父亲
董存瑞	董全忠	父亲
吉川元春	毛利元就	父亲
刘大鹏	刘明	父亲
林海音	林焕文	父亲
蔡旻纹	蔡柱陈	父亲
曹强	曹立军	父亲
爱新觉罗-永琪	乾隆皇帝	父亲
傅腾龙	傅天正	父亲
阿兰娜·韦斯顿	盖伦·韦斯顿	父亲
王洽	王珣	父亲
黎姿	黎柱	父亲
丁惟宁	丁纯	父亲
罗苹·莱特·潘	弗雷迪·盖儿·怀特	父亲
衮国大长公主	宋仁宗	父亲
张咏梅	张生荣	父亲
蔡龙云	蔡桂勤	父亲
马元章	马世麟	父亲
陈数	陈宗善	父亲
威廉王子	查尔斯-菲利浦-亚瑟-乔治-蒙巴顿-温莎	父亲
清河公主	晋惠帝	父亲
朱世业	朱湘泉	父亲
赵涛	赵洪讲	父亲
熊俊	熊汉中	父亲
晋成帝	司马绍	父亲
华彦钧	华清和	父亲
杨振铎	杨澄甫	父亲
拉丹·塔塔	J·R·D·塔塔	父亲
刘墉	刘统勋	父亲
奚啸伯	熙明	父亲
萧云峰	萧文雄	父亲
尹笑声	尹寿山	父亲
李浩天	李少春	父亲
胡先骕	胡承弼	父亲
方声洞	方址亭	父亲
周哀王	姬介	父亲
皮埃尔-萨科齐	尼古拉-萨科齐	父亲
丁子高	丁永方	父亲
林青霞	林维良	父亲
慕应雄	慕龙	父亲
富兰克林·皮尔斯	本杰明·皮尔斯将军	父亲
张菲	张舞曦	父亲
王文明	王守仁	父亲
那辛	那红生	父亲
詹世钗	詹真重	父亲
约翰·舍曼	查尔斯·罗伯特·舍曼	父亲
姬晨牧	姬麒麟	父亲
龙道权	段福泉	父亲
拓跋嗣	拓跋圭	父亲
刘思成	刘文瑞	父亲
李克用	李国昌	父亲
佩顿·曼宁	阿曲·曼宁	父亲
韩宗师	韩绛	父亲
何启	何福堂	父亲
弗里茨·埃里希·冯·曼施坦因	爱德华·冯·李文斯基	父亲
纪晓岚	容舒	父亲
郭靖	郭啸天	父亲
尹航	尹博林	父亲
许皇后	许广汉	父亲
杨伊琳	杨杜正	父亲
吴芳培	吴希文	父亲
刘盈	刘邦	父亲
小弗拉迪米尔·魏斯	弗拉迪米尔·魏斯	父亲
朱友珪	朱温	父亲
哈罗德·麦克米伦	莫里斯克劳福德麦克米伦	父亲
吴英	吴永正	父亲
孙萩亭	孙家仁	父亲
多斯·桑托斯	济济尼奥	父亲
李充	李矩	父亲
拉尔夫-舒马赫	罗尔夫-舒马赫	父亲
艾德-史塔克	瑞卡德-史塔克公爵	父亲
杨俊生	杨成武	父亲
武三思	武元庆	父亲
余英时	余协中	父亲
莉顿-梅斯特	Doug Meester	父亲
王美怡	王羽	父亲
大卫二世	罗伯特·布鲁斯	父亲
孙立群	孙震	父亲
毕季龙	毕振达	父亲
乔许-杜默	赖瑞-大卫-杜默	父亲
段波	段洪政	父亲
杨浣石	杨世沅	父亲
曹华	曹操	父亲
马克思	亨利希-马克思	父亲
曹晖	曹德旺	父亲
韩威侯	韩昭侯	父亲
邝埜	邝子辅	父亲
町村信孝	町村金五	父亲
郑志刚	郑家纯	父亲
梁文豪	梁华民	父亲
曹冲	曹操	父亲
韦紫明	迈克尔-史密斯	父亲
沈春华	沈丁旺	父亲
范岱年	范寿康	父亲
遂安公主	唐太宗李世民	父亲
杨诺思	杨受成	父亲
魏颗	魏武子	父亲
熊明霞	熊昌驹	父亲
长孙皇后	长孙晟	父亲
董海川	董守业	父亲
贯振山	贯盛习	父亲
艾尔·霍福德	蒂托·霍福德	父亲
王盛如	王贵山	父亲
姚凤凤	姚乔治	父亲
沙奎尔-奥尼尔	菲利浦-哈里森	父亲
贾宗洋	贾同才	父亲
姚苌	姚弋仲	父亲
方敏生	方心让	父亲
孟欣才	王立业	父亲
曾维信	曾德盛	父亲
周厚恩	周华健	父亲
卡罗尔-隆巴德	冯检基长彼得斯	父亲
陈树柏	陈济棠	父亲
尤异希	尤成华	父亲
顾锦辉	李修仁	父亲
叶芳	叶蓬	父亲
任平	任正非	父亲
约翰	亨利二世	父亲
郭子龙	郭新平	父亲
李辅	李慕	父亲
吴碧霞	王华安	父亲
孟少农	孟燮寅	父亲
于佑福	于福寿	父亲
屈玮	屈立忠	父亲
桃之助	狐火锦卫门	父亲
顾秀荣	顾锡轩	父亲
黄秋爽	黄文波	父亲
元恂	孝文帝元宏	父亲
韩厘侯	韩懿侯	父亲
郁飞	郁达夫	父亲
蒋得元	蒋万安	父亲
汪光焘	汪道涵	父亲
王湉湉	王庆华	父亲
肖恩-阿斯廷	约翰-奥斯汀	父亲
容启东	容星桥	父亲
向华胜	向华胜	父亲
李宁	李世波	父亲
朱音戠	朱徽煣	父亲
罗尚	罗蒙	父亲
张良	张平	父亲
徐润	徐宝亭	父亲
张宗之	张孟舒	父亲
徐和仲	徐梦吉	父亲
黄均	黃晉	父亲
阿尔瓦利德·本·塔拉尔	塔立尔·本·阿卜杜勒-阿齐兹	父亲
刘旦	汉武帝	父亲
陈群	陈纪	父亲
马克·韦伯	阿兰·韦伯	父亲
王莹	王怀俊	父亲
廖碧欣	廖烈文	父亲
郎朗	郎国任	父亲
马九斤	戴天理	父亲
叱干初古拔	叱干谨	父亲
李晓霞	李刚	父亲
钱媛	钱钟书	父亲
杜龛	杜岑	父亲
丽芙-泰勒	斯蒂文-泰勒	父亲
吴冰	吴文藻	父亲
江元生	江维华	父亲
郭维琴	郭士魁	父亲
斋藤道三	长井左卫门尉	父亲
布舒库	纳尔泰	父亲
罗布·福特	老德格·福特	父亲
帕丽斯·迈克尔·凯瑟琳·杰克逊	迈克尔·杰克逊	父亲
孔令民	孔祥泽	父亲
谢绍明	谢子长	父亲
上泉信纲	武蔵守秀继	父亲
冯润	冯熙	父亲
孙砾	孙天洪	父亲
布丽姬-穆娜	Brad Moynahan	父亲
赵文魁	赵永宽	父亲
耿世忠	耿永峰	父亲
朗·霍华德	琼·霍华德	父亲
谢朗	谢据	父亲
孛儿台	特薛禅	父亲
张闾琳	张学良	父亲
武延基	武承嗣	父亲
水均益	水天明	父亲
叶天士	叶朝采	父亲
美赫巴巴	希瑞亚·蒙德伽·伊朗尼	父亲
施温提·柏保	蘇恩·伯格斯特龙	父亲
许悦	许承恩	父亲
俞振庭	俞菊笙	父亲
武青婴	武烈	父亲
张广平	张吉文	父亲
李期	李雄	父亲
曹丕	曹叡	父亲
张宝昆	张梅五	父亲
贾跃亭	贾新安	父亲
吴鹏根	吴耀官	父亲
固伦和孝公主	乾隆皇帝	父亲
氏家卜全	氏家行隆	父亲
朱标	朱元璋	父亲
刘芬	刘琦	父亲
刘宝山	刘景文	父亲
丁丙	丁英	父亲
萨尔玛-海耶克	多明格斯	父亲
服部半藏	服部半三保长	父亲
刘畅	刘永好	父亲
孙明珠	孙柏龄	父亲
敬哀皇后	张麒	父亲
刘华清	刘顺山	父亲
李元名	李渊	父亲
范聚东	范庆澜	父亲
亚历山大·瓦西里耶维奇·苏沃洛夫	瓦西里·苏沃洛夫	父亲
范维唐	范治纶	父亲
陈慥	陈希亮	父亲
朱桂芳	朱文英	父亲
毛宇居	毛福生	父亲
唐宪宗嫡妻懿安皇后郭氏	郭暧	父亲
金·凯利	珀西·约瑟夫·凯瑞	父亲
唐三	唐昊	父亲
陈永明	陈振先	父亲
陈丽君	陈青远	父亲
涅阳公主	汉光武帝	父亲
弗兰克·迪兰	斯蒂芬·迪兰	父亲
傅尧笙	傅长敏	父亲
三国魏司徒陈矫之子	陈矫	父亲
索菲亚-科波拉	弗朗西斯-福特-科波拉	父亲
修武公主	汉和帝	父亲
李荣	李志	父亲
李俊生	李玉安	父亲
胡石英	胡乔木	父亲
吉几三	鎌田稲一	父亲
庞贵生	张玉森	父亲
杨康	杨铁生	父亲
唐博	唐进良	父亲
张曜灵	张重华	父亲
俞明诗	俞文葆	父亲
吴阶平	吴敬仪	父亲
陈照奎	陈发科	父亲
拿破仑-波拿巴	卡洛-波拿巴	父亲
约翰·福赛斯	罗伯特·福赛斯	父亲
刘轩	刘墉	父亲
沈斌泉	沈寿林	父亲
王僧孺	王延年	父亲
阿卜杜拉	伊本-沙特	父亲
唐寅	唐广德	父亲
弗拉德	弗拉德二世	父亲
平岩亲吉	平岩亲重	父亲
梁司渝	梁锦松	父亲
范宝亭	范福泰	父亲
刘胥	刘彻	父亲
奥格-尼尔斯-玻尔	尼尔斯-玻尔	父亲
保罗-加索尔	奥古斯提	父亲
孙鲁班	孙权	父亲
方青卓	方冰	父亲
颜章根	陈文彬	父亲
刘毓中	刘立杰	父亲
高桥真梨子	森冈月夫	父亲
魏萌	魏善斋	父亲
王征	盛毓南	父亲
张遵	张苞	父亲
周杰伦	周耀中	父亲
陈松龄	陈富瑞	父亲
文年生	文养然	父亲
汤姆·汉克斯	艾摩斯·汉克斯	父亲
李成伟	李光前	父亲
赖宁	赖正纲	父亲
赫尔穆特·科尔	汉斯·科尔	父亲
舒舒	曾志文	父亲
丁立钧	丁绍周	父亲
董良翚	董必武	父亲
马可-波罗	尼科洛	父亲
白景琦	白颖轩	父亲
布鲁克林·贝克汉姆	大卫·贝克汉姆	父亲
威廉·劳伦斯·布拉格	威廉·亨利·布拉格	父亲
晋宣帝	司马防	父亲
德克·诺维茨基	约尔格	父亲
玛哈-扎克里-诗琳通	普密蓬-阿杜德	父亲
尚丽华	宋文起	父亲
郑振声	郑雨芬	父亲
谭富英	谭小培	父亲
项南	项与年	父亲
黄忆慈	黄磊	父亲
陈荟莲	陈首林	父亲
东汉末年故安都尉	陈球	父亲
阿道夫·希特勒	阿洛伊斯·希特勒	父亲
熊佳庆	熊伟忠	父亲
爱新觉罗-弘曕	雍正帝	父亲
孙莹莹	孙道存	父亲
盛华	盛延祺	父亲
徐锵	徐代泉	父亲
米歇尔-莫娜汉	鲍伯-莫娜汉	父亲
曾国犹	曾志伟	父亲
刘纯燕	刘兴沛	父亲
詹姆斯·乔伊斯	约翰·乔伊斯	父亲
徐志忠	徐仁福	父亲
姚珏	姚笛	父亲
王梓	王华英	父亲
刘盈	刘恭	父亲
朱蕴山	朱瑞生	父亲
王贞凤	王僧郎	父亲
阿尼尔-阿姆巴尼	迪鲁拜-阿姆巴尼	父亲
王淑芳	王广亚	父亲
程峰	程守忠	父亲
任明明	任亚波	父亲
张亚雯	张伟	父亲
张学海	张君秋	父亲
郑庄公	郑武公	父亲
玛瑞丝卡-哈吉塔	麦琪-哈吉塔	父亲
小罗伯特·唐尼	罗伯特·唐尼	父亲
廖承志	廖仲恺	父亲
朴忠载	查理朴	父亲
爱德华多-弗雷	爱德华多-弗雷-蒙塔尔瓦	父亲
李小鹏	李真愚	父亲
李健吾	李鸣风	父亲
叶金援	叶盛长	父亲
张玲霞	张景寿	父亲
蒂勒	阿诺德·蒂勒	父亲
哈维尔-埃尔南德斯	哈维尔埃尔南德斯古铁雷斯	父亲
张娜拉	朱虎声	父亲
黄遵宪	黄鸿藻	父亲
王泽	王家禧	父亲
约翰·沃尔顿	卢克·沃尔顿	父亲
仁德王后	元代皇族魏王－孛罗帖木儿	父亲
赵如泉	赵祥玉	父亲
恩里克-伊格莱西亚斯	胡里奥-伊格莱西亚斯	父亲
艾蜜莉·莫特	约翰·莫迪默	父亲
甄洛	甄逸	父亲
爱新觉罗-胤禔	爱新觉罗-玄烨	父亲
刘胜	刘启	父亲
咸宜公主	唐玄宗	父亲
汪仲韦	汪汉溪	父亲
黄富强	黄振龙	父亲
夏末帝	李德仁	父亲
刘义隆	宋武帝	父亲
李泰祥	李光雄	父亲
维恩	卡尔-维恩	父亲
洪适	洪皓	父亲
胡志明	阮生辉	父亲
赵四小姐	赵庆华	父亲
鲁思-本尼迪克特	佛雷迪-富尔顿	父亲
林恬儿	林建岳	父亲
石破天	石清	父亲
钦察答纳失里	平王燕铁木尔	父亲
黄绍第	黄体芳	父亲
傅长敏	傅尧笙	父亲
李恒	胡耀邦	父亲
贾斯汀-沃德尔	Gordon	父亲
孝诚仁皇后	赫舍里·噶布喇	父亲
詹姆斯-默多克	默多克	父亲
希尔顿	格斯-希尔顿	父亲
罗温-艾金森	艾里克-艾金森	父亲
王新全	王连聚	父亲
王通	王琳	父亲
李丞责	李发文	父亲
王瑜	王振虎	父亲
王石	王辉	父亲
刘騊駼	刘复	父亲
恭僖皇后	王绍卿	父亲
邹市明	邹建国	父亲
迪尔玛-罗塞夫	佩德罗-罗塞夫	父亲
叶庆先	叶荫章	父亲
王莹	王怀俊	父亲
何基鸿	何士杰	父亲
宋庆龄	宋嘉树	父亲
陈同海	陈伟达	父亲
杨延昭	杨继业	父亲
吉奥瓦尼-多斯桑托斯	济济尼奥	父亲
阿灵阿	遏必隆	父亲
宇绍	朱松	父亲
翟田田	翟泰山	父亲
杨小钰	杨震	父亲
玛丽·切尼	迪克·切尼	父亲
李健熙	李秉喆	父亲
石勒	周曷朱	父亲
安赫尔·迪玛利亚	Miguel	父亲
孙鲁育	孙权	父亲
刘琪琪	刘焕生	父亲
王士英	王又宸	父亲
杨健侯	杨露蝉	父亲
张伯苓	张云藻	父亲
乔治·巴顿	乔治·史密斯·巴顿	父亲
佟铁鑫	佟笑梦	父亲
迈克尔·布拉德利	鲍勃·布拉德利	父亲
爱新觉罗-永瑆	爱新觉罗-弘历	父亲
孙海英	丁尼	父亲
宋亚平	宋曾诒	父亲
顾桐峻	顾云亭	父亲
腓力五世	德米特里二世	父亲
努尔哈赤	爱新觉罗·塔克世	父亲
樊少皇	樊梅生	父亲
伯里克利	山提波斯	父亲
周云帆	周小川	父亲
刘将孙	刘辰翁	父亲
陈恭尹	陈邦彦	父亲
朱宸濠	朱觐钧	父亲
穆罕默德	阿卜杜拉	父亲
李喜儿	李宗盛	父亲
斯特林-莫斯	阿尔弗雷德-莫斯	父亲
陈蓓	陈斌	父亲
斛律恒伽	斛律光	父亲
赵孟頫	赵与	父亲
金-阿里斯	阿里斯	父亲
王小波	王方名	父亲
张德俊	张玉林	父亲
尼尔-布什	乔治-赫伯特-沃克-布什	父亲
孟潇旻	孟斐璇	父亲
皮晓萌	皮黔生	父亲
陈玲玲	王维艰	父亲
席代瑜	席世鋆	父亲
张秀山	张如德	父亲
米芾	米佐	父亲
李倩	李祝健	父亲
黎灼灼	黎海山	父亲
安格拉-默克尔	霍斯特	父亲
马里恩·克利夫兰·德尔·阿门	格罗弗·克利夫兰	父亲
容庚	庆得子	父亲
李天蔚	李伟才	父亲
顾敏恒	顾奎光	父亲
吉姆·沃尔顿	萨姆·沃尔顿	父亲
范小青	范万均	父亲
娜塔丽-波特曼	Avner	父亲
袁永刚	袁富根	父亲
余笑予	余文君	父亲
艾尔顿·冼拿	密爾頓	父亲
周巍峙	周慰堂	父亲
关凌	关文凯	父亲
艾伦·耶格尔	格里沙·耶格尔	父亲
刘翔	刘学根	父亲
刘琮	刘表	父亲
凯姆·吉甘戴	Jay	父亲
马林	马学文	父亲
曹嵩	夏侯睿	父亲
王秋杨	王成斌	父亲
刘翼	刘开	父亲
王贞谔	王叙炽	父亲
阮次山	阮中歧	父亲
珍妮丝·狄金森	雷·狄金森	父亲
章益	章心培	父亲
翁倩玉	翁炳荣	父亲
谢伯俞	谢炳坤	父亲
张梦实	张景惠	父亲
叶爱群	叶建民	父亲
张忠祥	张志荣	父亲
托尼-帕克	托尼	父亲
方增先	方自成	父亲
俞振飞	俞粟庐	父亲
陈龙正	陈于王	父亲
甘涛	甘贡三	父亲
邹奇奇	约翰·史维泰克	父亲
胡木英	胡乔木	父亲
刘子张	刘利	父亲
萧镇奎	萧文祥	父亲
陈宝应	陈羽	父亲
尼古拉斯-凯奇	奥古斯特-科波拉	父亲
张克澄	张维	父亲
爱新觉罗-文嘉	溥佺	父亲
爱新觉罗·永璟	爱新觉罗·弘历	父亲
刘子歌	刘立辉	父亲
尉迟宝林	尉迟恭	父亲
陈称	陈世卿	父亲
广末凉子	广末忠彦	父亲
李克威	李准	父亲
宋太祖	宋宣祖	父亲
唐文治	唐若钦	父亲
朱啸风	朱烨	父亲
韩林儿	韩山童	父亲
哈雅公主	侯赛因-伊本-塔拉勒	父亲
李东红	李明堂	父亲
阿兰·琼斯	斯坦·琼斯	父亲
王力宏	王大中	父亲
艾未未	艾青	父亲
琼·亨利·杜南	让·雅克·杜南	父亲
黎明晖	黎锦晖	父亲
圣德太子	用明天皇	父亲
陈若琳	成勇金	父亲
徐志摩	徐申如	父亲
彭春平	彭朝贵	父亲
袁家骝	袁克文	父亲
郑屹	郑文昆	父亲
朱塞佩·威尔第	卡罗·朱塞佩·威尔第	父亲
朱植	朱元璋	父亲
赵燕侠	赵小楼	父亲
阿剌海别吉	成吉思汗	父亲
何开梓	何猷龙	父亲
霍震寰	霍英东	父亲
范祖禹	范百祉	父亲
郭亚琼	郭德林	父亲
小芳	孙悟饭	父亲
常安公主	明世宗	父亲
于若木	于明信	父亲
月咏歌呗	月咏或斗	父亲
房仕德	房道龙	父亲
宋遇春	宋永珍	父亲
布拉德-纽利	阿瑟-纽利说	父亲
刘鸿举	刘子珍	父亲
刘宇杰	刘承嗣	父亲
梁妠	梁商	父亲
艾莉森·威廉姆斯	布莱恩·威廉姆斯	父亲
米娅-科施娜	Sheldon Kirshner	父亲
弗朗西斯科-法布雷加斯	法兰西斯克-法布雷加斯	父亲
范徐丽泰	徐大统	父亲
刘弗陵	刘彻	父亲
托勒密十三世	托勒密十二世	父亲
永穆公主	唐玄宗	父亲
黄玉珊	黄奎	父亲
牛子厚	牛化麟	父亲
麦哲伦	路易-德-麦哲伦	父亲
李海泉	李震彪	父亲
范子妤	范智岳	父亲
陈荣启	陈福庆	父亲
任小乐	任光晞	父亲
刘渊	刘豹	父亲
林宏伟	林建国	父亲
quintus	谢霆锋	父亲
乔治-亚历山大-路易斯	威廉王子	父亲
陈云凤	陈嘉言	父亲
小弗雷迪-普雷兹	弗雷迪-普林斯	父亲
莉娜·杜汉姆	罗尔·杜汉姆	父亲
陈延熙	陈耕耘	父亲
梁鸿	梁让	父亲
图坦卡蒙	阿蒙霍特普四世	父亲
郭令山	郭晋安	父亲
乔许·杜默	赖瑞·大卫·杜默	父亲
慕容垂	慕容皝	父亲
冯桂鑫	冯续奎	父亲
刘德妃	刘通	父亲
李淑媛	李万春	父亲
田中千绘	田中东尼	父亲
徐立才	徐世英	父亲
筱玉霜	龚万才	父亲
近卫秀麿	近卫笃麿	父亲
佐伊-丹斯切尔	Caleb Deschanel	父亲
殷素素	殷天正	父亲
王恬	王导	父亲
戴韫	戴春洪	父亲
小约翰·施特劳斯	约翰·施特劳斯	父亲
宇文云英	宇文泰	父亲
爱新觉罗-多尔衮	爱新觉罗-努尔哈赤	父亲
薄熙莹	薄一波	父亲
爱新觉罗-胤祺	爱新觉罗-玄烨	父亲
泰戈尔	代温德拉纳特	父亲
莫林根	顾云奎	父亲
切尔西-克林顿	比尔-克林顿	父亲
唐睿宗女	唐睿宗李旦	父亲
穆黄花	宋钦道	父亲
哈维尔-埃尔南德斯	哈维尔-埃尔南德斯-古铁雷斯	父亲
小弗雷迪·普雷兹	弗雷迪·普林斯	父亲
吕青橙	吕秀才	父亲
忆陈毅	郑振铎	父亲
罗援	罗青长	父亲
魏圣美	魏炳旭	父亲
李星阶	李钧	父亲
孙虑	孙权	父亲
孙见坤	孙伟	父亲
蔡加敏	蔡志明	父亲
李阳鸣	李卜春	父亲
约翰·卢卡斯三世	约翰·卢卡斯二世	父亲
朱慈照	朱由检	父亲
尼格买提-热合曼	热合曼-马木提	父亲
乔松	李含芳	父亲
康辰晨	康小犀	父亲
李登辉	李国福	父亲
朱正华	朱兆祥	父亲
刘镇邦	刘占金	父亲
米高·辛	Meyrick	父亲
张敬修	张居正	父亲
霍元甲	霍恩第	父亲
藤森庆子	阿尔韦托·藤森	父亲
程镇元	程子其	父亲
孟遏云	孟光华	父亲
孙文锋	孙俊明	父亲
完颜绥可	完颜跋海	父亲
马叙伦	马琛书	父亲
浦琼英	浦在廷	父亲
蒋英	著名军事理论家蒋百里	父亲
利奥波德二世	利奥波德一世	父亲
瓦妮莎·雷德格瑞夫	迈克尔爵士	父亲
陈松年	陈独秀	父亲
董浩	董静山	父亲
郝慰民	郝履成	父亲
陈钰芸	陈源瀚	父亲
阿比盖尔-约翰逊	爱德华-约翰逊	父亲
嘉德帝姬	宋徽宗	父亲
吴卓林	成龙	父亲
章得象	章世涣	父亲
侯蕴华	侯孝贤	父亲
爱新觉罗·皇太极	努尔哈赤	父亲
常宝华	常连安	父亲
赵佶	赵顼	父亲
陈尧叟	陈省华	父亲
珠儿·克尔奇	亚兹·克尔奇	父亲
孙同鑫	孙振东	父亲
蔡温	蔡铎	父亲
郑之蕃	郑式如	父亲
甲丁	洪源	父亲
曹操	曹彰	父亲
吴冰	吴文藻	父亲
林毅夫	林火树	父亲
赛义德-穆罕默德-哈塔米	鲁霍拉-哈塔米	父亲
艾莉森-萨罗芬	法耶兹-沙拉比-萨罗芬	父亲
王彦泓	王懋锟	父亲
向仲华	向国泽	父亲
乔治二世	乔治一世	父亲
刘盛亚	刘运筹	父亲
万昊	万籁鸣	父亲
宋蔼龄	宋嘉树	父亲
克鲁泽	艾尔-达-佛拉达	父亲
慕容令	慕容垂	父亲
张仕波	张宗逊	父亲
李耀录	李文军	父亲
杨光勋	杨文麟	父亲
李宏塔	李葆华	父亲
苏辙	苏洵	父亲
任平	任正非	父亲
塞贝克诺弗鲁	阿门涅姆赫特三世	父亲
元顺帝	明宗和世剌	父亲
孙宪法	孙希民	父亲
王佑	王彻	父亲
徐丽丽	徐洪春	父亲
金-凯瑞	珀西-约瑟夫-凯瑞	父亲
罗玉通	罗盛强	父亲
迟喜珠	迟寿生	父亲
金祖同	金颂清	父亲
薛济杰	薛志轩	父亲
高逸鸿	高朴斋	父亲
姚沁蕾	姚明	父亲
赵宗实	赵允让	父亲
哈米德-卡尔扎伊	阿巴杜尔-阿哈德-卡尔扎伊	父亲
宋铁麟	宋世德	父亲
宋以朗	宋淇	父亲
李炜	李斌	父亲
一世达赖	贡布多吉	父亲
昌乐公主	唐玄宗	父亲
齐王建	齐襄王田法章	父亲
孝诚仁皇后	赫舍里-噶布喇	父亲
徐继畲	徐润第	父亲
草婴	盛济舲	父亲
张四全	张盛庭	父亲
李玄旭	李异洲	父亲
白浪	白帆	父亲
闫素侠	闫世贞	父亲
程虹	程金瑞	父亲
曼莫汉-辛格	古尔蒙克-辛格	父亲
巴伊亚-巴卡里	卡西姆-巴卡里	父亲
甄珩	甄远道	父亲
李愔	李世民	父亲
彭立尧	彭九华	父亲
李惟岳	李宝臣	父亲
袁承志	袁崇焕	父亲
杨峰岩	杨炳坤	父亲
郝明莉	郝德望	父亲
周玉	周永明	父亲
燕昭公	燕宣公	父亲
高雪樵	高俊亭	父亲
戴梓伊	戴玉强	父亲
加藤弘之	加藤正照	父亲
颜珍	颜地	父亲
昭宪太后	杜爽	父亲
杨丽华	隋文帝	父亲
刘命兰	刘天赐	父亲
田雨晨	田伟	父亲
薛灵芸	薛业	父亲
张继科	张传铭	父亲
王光美	王治昌	父亲
李珍荣	李瑞云	父亲
贺子珍	贺焕文	父亲
张永久	张筱波	父亲
刘熊渠	刘买	父亲
刘秀	刘钦	父亲
朱孟爟	朱桢	父亲
陈非侬	陈伯寅	父亲
陈晨	陈灵奇	父亲
诸葛流云	诸葛青天	父亲
钟灵	段正淳	父亲
梁昭贤	梁庆德	父亲
查尔斯-罗尔斯	洛德兰加特克勋爵	父亲
陈天宇	陈定基	父亲
阿什丽-格林尼	乔-格林	父亲
吉安娜-普罗德摩尔	戴林-普罗德摩尔	父亲
朱有燆	朱橚	父亲
刘子源	刘露	父亲
Marie Trintignan	让-路易斯-特兰蒂尼昂	父亲
朱偕灊	朱征钋	父亲
莉莉??艾伦	基思-艾伦	父亲
吴林焕	吴绍富	父亲
艾玛-罗伯茨	Eric Roberts	父亲
邓吉元	邓孝刚	父亲
格伦-罗宾逊	克里斯蒂安-布里奇曼	父亲
黄嗜墨	黄画波	父亲
德川家纲	德川家光	父亲
葛怀中	葛兆涵	父亲
杰西-斯宾塞	罗德尼-斯宾塞	父亲
娄师白	娄德美	父亲
辛婷	辛青山	父亲
西尔维斯特-史泰龙	弗兰克-史泰龙	父亲
让-雷诺阿	奥古斯特-雷诺阿	父亲
福成公主	朱兴隆	父亲
萧道成	萧承之	父亲
程卫	程世春	父亲
赵维仁	赵忠尧	父亲
孙志浩	孙文骐	父亲
玛格丽特-杜鲁门-丹尼尔	哈里-S-杜鲁门	父亲
田蕴章	田荫亭	父亲
孙晓娆	孙通达	父亲
楚穆王	楚成王	父亲
邱达根	邱德根	父亲
孙权	孙亮	父亲
凯瑟琳-海格尔	保罗-海格尔	父亲
王蒙	王锦	父亲
朱塞佩·罗西	菲尔迪南多·罗西	父亲
石川辽	石川胜美	父亲
吴蔚然	吴敬仪	父亲
珍妮佛·嘉纳	比利·杰克·嘉纳	父亲
吴樾	吴尔康	父亲
马俊明	马彭伸	父亲
林彪	林明卿	父亲
杨善洲	杨发龙	父亲
傅二石	傅抱石	父亲
毛承斗	毛文龙	父亲
赫伦尼乌斯	德基乌斯	父亲
郑永春	郑玉华	父亲
彭孙遹	彭期生	父亲
郑道昭	郑羲	父亲
梅希文	梅立中	父亲
孙玥	孙锦华	父亲
杨澜	杨鑫楠	父亲
张居正	张文明	父亲
蒋中正	蒋纬国	父亲
刘恺威	刘丹	父亲
唐高宗李治第二子	唐高宗	父亲
朱栴	朱元璋	父亲
萨哈廉	代善	父亲
施世骠	施琅	父亲
贾至	贾曾	父亲
朱恩馀	朱敬文	父亲
窦抗	窦荣定	父亲
孝淑睿皇后	和尔经额	父亲
吴炳璋	吴松岩	父亲
黄博文	黄俊伟	父亲
耶梦加得	洛基	父亲
郭女王	郭永	父亲
刘琼	刘本之	父亲
元愉	元宏	父亲
梁小雷	梁光夫	父亲
郗璿	郗鉴	父亲
吕庆欣	吕元祥	父亲
张治中	张桂徵	父亲
小西行长	小西隆佐	父亲
夏尔-凡多姆海恩	文森-凡多姆海恩	父亲
郑洁	郑书凯	父亲
舒娇	舒翁	父亲
威廉·亚历山大·克劳斯·乔治·费迪南德	克劳斯亲王	父亲
唐志中	唐威	父亲
沈容	沈泽苍	父亲
赵建铭	赵玉柱	父亲
陈彤云	陈树人	父亲
鲁比娜-阿里	拉菲克-库雷希	父亲
黄若	黄英森	父亲
阴安公主	汉章帝	父亲
林志刚	林孚昌	父亲
福康安	富察-傅恒	父亲
刘延寿	刘纯	父亲
任志强	任泉生	父亲
丁肇中	丁关海	父亲
德克-诺维茨基	约尔格	父亲
陈富涛	陈嘉梁	父亲
郑燕然	郑新潮	父亲
陈伟华	陈云	父亲
李德才	李秉福	父亲
陈勇	陈坊仁	父亲
齐邦媛	齐世英	父亲
杨之华	杨羹梅	父亲
戴娆	厉广源	父亲
王德占	王楠	父亲
石田雨龙	石田龙弦	父亲
凯拉-奈特利	威尔-奈特利	父亲
李百龄	李光烈	父亲
庄思明	庄宝	父亲
余叔岩	余紫云	父亲
郑克臧	郑经	父亲
张晓杰	张松茂	父亲
孙广才	孙有元	父亲
吴凯庭	吴惠天	父亲
李晓林	李雪峰	父亲
孙正义	孙三宪	父亲
邱康民	邱庆沛	父亲
陈嘉言	陈虎臣	父亲
严四光	严济慈	父亲
宇文士及	宇文述	父亲
楚庄王	楚穆王	父亲
李虹	李歇浦	父亲
奚安竹	艾伯特·威廉·西顿	父亲
郭永淳	郭志权	父亲
梁启勋	梁思睿	父亲
李天杨	李牧坚	父亲
周保权	周行逢	父亲
谢元龙	谢英	父亲
杨婵	杨天佑	父亲
樊金奎	樊顺福	父亲
杨玉环	杨玄琰	父亲
颜真卿	颜惟贞	父亲
孙晔	孙怀荣	父亲
阿伊莎·卡扎菲	卡扎菲	父亲
林凡	林满	父亲
刘继山	刘学庭	父亲
刘庸	刘统勋	父亲
程菲	程立高	父亲
许美慧	许铭辉	父亲
邵亦波	邵振平	父亲
苏雪	苏建国	父亲
丽兹-切尼	迪克-切尼	父亲
让·巴蒂斯·西美翁·夏尔丹	让·夏尔丹	父亲
孙匡	孙坚	父亲
傅汉思	赫尔曼·弗兰克尔	父亲
明成皇后	闵致禄	父亲
庆都公主	明仁宗朱高炽	父亲
萨曼莎-斯托瑟	托尼	父亲
张承中	张世良	父亲
傅锐	彭真	父亲
张九皋	张世炀	父亲
丁世家	丁和木	父亲
夏侯光姬	夏侯庄	父亲
和硕怀恪公主	爱新觉罗-胤禛	父亲
张月亮	张铁林	父亲
梁世平	梁致和	父亲
邹林颖	邹戈	父亲
马克-韦伯	阿兰-韦伯	父亲
福原信三	福原有信	父亲
庄德智	庄瑞渊	父亲
杨班候	杨露禅	父亲
李敖	李鼎彝	父亲
爱新觉罗-永璟	乾隆皇帝	父亲
威廉-伦道夫-赫斯特	乔治-赫斯特	父亲
赵景子	赵文子	父亲
汤古代	清太祖	父亲
苻训英	苻谟	父亲
粟戎生	粟裕	父亲
文彭	文征明	父亲
查理-希恩	马丁-希恩	父亲
关羽	关毅	父亲
许庆祥	许雅钧	父亲
东晋王导次子	王导	父亲
王贤志	王忠桐	父亲
董子健	董志华	父亲
陈祖德	陈汉章	父亲
伍云甫	伍如春	父亲
韦丛	韦夏卿	父亲
蔡慧亭	蔡达标	父亲
Craig David	George David	父亲
朱江涛	朱天文	父亲
王少生	王琴生	父亲
千里驹	区星朝	父亲
东乡公主	曹丕	父亲
赵胜	赵武灵王	父亲
曹仁	曹炽	父亲
刘启	汉文帝	父亲
波德莱尔	约瑟夫	父亲
陈发科	陈延熙	父亲
岳屾山	岳成	父亲
李家杰	李兆基	父亲
宋哀公	宋惠公	父亲
于世文	筱翠花	父亲
乌汶叻公主	普密蓬·阿杜德	父亲
张克潜	张度	父亲
宇陀宁玛·元丹贡布	琼布多杰	父亲
妮可-基德曼	Anthony Kidman	父亲
约瑟夫·莱恩斯	迈克尔里昂	父亲
李昌镐	李古龙	父亲
胡竞先	胡寿昌	父亲
唐纳德·特朗普	弗雷德·特朗普	父亲
保罗-马尔蒂尼	塞萨尔-马尔蒂尼	父亲
昭成皇后窦	窦孝谌	父亲
爱新觉罗-皇太极	努尔哈赤	父亲
李敏	毛泽东	父亲
张佩纶	张印塘	父亲
朴赞仁	朴建绪	父亲
孙翠凤	孙贵	父亲
曹芳	曹楷	父亲
李允馨	李健熙	父亲
王崇烈	王懿荣	父亲
胡雪桦	胡伟民	父亲
杨菊萍	小杨月楼	父亲
寿康公主	宋英宗	父亲
傅光宅	傅学易	父亲
余玉琴	余顺成	父亲
张晨	张友生	父亲
乔姆斯基	威廉-乔姆斯基	父亲
朱徽娟	明光宗朱常洛	父亲
塔米尔·科恩	阿维·科恩	父亲
陈丽达	陈强	父亲
魏敏芝	魏玉清	父亲
尹月樵	尹子斌	父亲
杨慎	杨廷和	父亲
王启明	王宗发	父亲
徐凌云	徐棣山	父亲
谢荔梅	谢景森	父亲
叶少兰	叶明	父亲
白歆惠	白国嘉	父亲
小仲马	大仲马	父亲
李昌奎	李顺祥	父亲
邵邨人	邵玉轩	父亲
帖木儿不花	脱欢	父亲
谢振轩	谢霆锋	父亲
周代宋国始祖	帝乙	父亲
莫科	莫连贵	父亲
陆英修	陸鍾寬	父亲
刘学思	刘炳森	父亲
苏冠兰	苏凤琪	父亲
林德华	林寿杲	父亲
西尔维娅·索莫莱特	瓦尔特·索莫莱特	父亲
武威公主	拓跋嗣	父亲
广德公主	明英宗朱祁镇	父亲
王小蒙	王老七	父亲
蒋介卿	蒋肇聪	父亲
朱厚照	朱佑樘	父亲
秦孝公	秦献公	父亲
李元昊	李德明	父亲
涅音梦	涅茧利	父亲
钱思亮	钱鸿业	父亲
姜一郎	姜文	父亲
宋宜昌	宋平	父亲
包韵竹	包天笑	父亲
刘维宁	刘允斌	父亲
沈钧儒	沈翰	父亲
谭晓风	谭咏麟	父亲
朱玉安	朱桂芳	父亲
威廉·梅克比斯·萨克莱	李奇蒙·萨克雷	父亲
梅贻琦	梅曾臣	父亲
霍华德·弗洛里	约瑟夫·弗洛里	父亲
曹熊	曹操	父亲
亚瑟·叔本华	海因里希·弗洛里斯·叔本华	父亲
朱安婕	邢峰	父亲
邓锦康	邓永泉	父亲
曹干	曹操	父亲
蒋明章	蒋光清	父亲
李殿林	李增桂	父亲
魏国楚国大长公主	宋英宗	父亲
城阳公主	李世民	父亲
张良	张平	父亲
王雪峰	王昆和	父亲
吴光明	吴连福	父亲
郑东	郑贵初	父亲
丁乃刚	丁梦熊	父亲
苏我石川麻吕	苏我仓麻吕	父亲
文震亨	文元发	父亲
陈满林	陈兆	父亲
林徽因	林长民	父亲
黑崎一护	黑崎一心	父亲
黄蓉	东邪黄药师	父亲
李林	李四光	父亲
萧亚轩	萧尧	父亲
刘德舟	刘同丰	父亲
华阳公主	唐代宗	父亲
曹东扶	曹怀清	父亲
田英章	田荫亭	父亲
萧长懋	萧赜	父亲
林立仁	林耀南	父亲
武惠妃	武攸止	父亲
林金	金	父亲
李荣岩	李春林	父亲
廖梦醒	廖仲恺	父亲
孙盛武	孙棣珊	父亲
甘麻剌	元裕宗真金	父亲
凌霜华	凌退思	父亲
唐兹成	唐藩	父亲
沈琼	沈志平	父亲
蔡锷	蔡正陵	父亲
胡德华	胡耀邦	父亲
郝润泽	郝海东	父亲
厉慧森	厉彦芝	父亲
穆罕默德-查希尔	穆罕默德-纳迪尔	父亲
蒋友柏	蒋孝勇	父亲
王仲闻	王国维	父亲
王保和	王福寿	父亲
荀皓	荀令香	父亲
赵丹	赵子超	父亲
赵伟洲	赵心敏	父亲
尼格尔-德容	杰瑞-德容	父亲
蒲生氏乡	蒲生贤秀	父亲
梁冀	梁商	父亲
郑家纯	郑裕彤	父亲
陈武帝	陈文赞	父亲
李国宝	李福树	父亲
卡梅隆-道格拉斯	迈克尔-道格拉斯	父亲
伊万卡-特朗普	唐纳德-特朗普	父亲
陈少默	陈树藩	父亲
徐冠巨	徐传化	父亲
张起岩	张范	父亲
黄摩西	黄若愚	父亲
马秀英	马二公	父亲
李兆麟	李介甫	父亲
汉惠帝刘盈的嫡妻张皇后	张敖	父亲
傅子恩	傅彪	父亲
汪皓	汪家栋	父亲
陈元光	陈政	父亲
杨俊生	杨成武	父亲
宋世德	宋永禄	父亲
朱孟焯	朱桢	父亲
李家诚	李兆基	父亲
马三立	马志明	父亲
玛塔·奥特加·佩雷斯	阿曼西奥·奥特加	父亲
王北星	王长友	父亲
杰罗梅·博阿滕	普林斯·博阿滕	父亲
林黛	程思远	父亲
沈劲	沈充	父亲
凯拉·奈特利	威尔·奈特利	父亲
韩宗彦	韩纲	父亲
伯纳德-阿诺特	吉恩-阿诺特	父亲
廖晖	廖承志	父亲
江蛰君	江世俊	父亲
吴娃	吴广	父亲
余理洋	余星友	父亲
杨炅	杨广香	父亲
郑武公	郑桓公	父亲
杰拉德	弗烈德里克	父亲
邱波	邱水银	父亲
朱盛富	朱湘泉	父亲
嵇康	嵇昭	父亲
胡仔	胡舜陟	父亲
蔡居厚	蔡承禧	父亲
路德维希二世	马克西米利安二世	父亲
桂涵	桂天聪	父亲
曾纪泽	曾国藩	父亲
莉莉安·贝当古	欧仁·舒埃勒	父亲
琼瑶	陈致平	父亲
大和卓波罗尼都	玛罕木特	父亲
沈俊成	沈长富	父亲
杨志泛	杨兰景	父亲
乔什-布洛林	詹姆斯-布洛林	父亲
归善公主	明世宗朱厚熜	父亲
王成意	王先光	父亲
威斯利·斯内德	巴里斯内德	父亲
关之琳	关伯威	父亲
叶诗文	叶松青	父亲
黄光裕	黄昌义	父亲
容永道	容翼庭	父亲
赵一楠	赵本山	父亲
哈维尔-埃尔南德斯	哈维尔??埃尔南德斯??古铁雷斯	父亲
雷声	雷献民	父亲
王焘	李敬直	父亲
刘辩	刘宏	父亲
叶向真	叶剑英	父亲
马特·德拉吉	罗伯特·德拉吉	父亲
王新欣	王克	父亲
李玢	唐玄宗	父亲
东条由布子	东条英隆	父亲
塞尔吉奥-布斯克茨	卡莱斯-卡洛斯-布斯克茨	父亲
祖丁	祖辛	父亲
雪村	韩静霆	父亲
小泉进次郎	小泉纯一郎	父亲
查尔斯-罗尔斯	洛德??兰加特克勋爵	父亲
杨丽君	杨文权	父亲
努尔王后	纳吉布-伊利亚斯-哈拉比	父亲
凯伦-卡本特	哈罗德-伯特伦-卡彭特	父亲
潘岳	潘田	父亲
郑志恒	郑家成	父亲
张惠民	张子林	父亲
金正男	金正日	父亲
汪桂英	汪野亭	父亲
南宫公主	刘启	父亲
阿敏-马卢夫	鲁查迪-马卢夫	父亲
张勉之	张大宁	父亲
陆国才	陆一帆	父亲
汤子康	汤德苏	父亲
瑞贝卡-布莱克	约翰-布莱克	父亲
爱德华多·弗雷	爱德华多·弗雷·蒙塔尔瓦	父亲
司马光	司马池	父亲
孙梅堂	孙廷源	父亲
李明达	唐太宗李世民	父亲
齐豫	齐济	父亲
林风眠	林雨农	父亲
沘阳公主	刘强	父亲
朱仲丽	朱剑凡	父亲
娜塔莎-艾德礼	斯图亚特-艾德礼	父亲
王弢	王茂俊	父亲
毛利胜永	毛利胜信	父亲
康康	康昆平	父亲
陈升琳	陈锦海	父亲
时大彬	时朋	父亲
周楚	周抚	父亲
木村心美	木村拓哉	父亲
哀姜	齐襄公	父亲
哈姆扎·本·拉登	本·拉登	父亲
拿破仑二世	拿破仑-波拿巴	父亲
萧远山	乔峰	父亲
张少楼	张月楼	父亲
李林子	李述一	父亲
胡世华	胡惟德	父亲
拉克兰-默多克	鲁伯特-默多克	父亲
刘义	卢正涛	父亲
莫宣卿	莫让仁	父亲
李思训	李孝斌	父亲
陈寅恪	陈三立	父亲
顾国华	顾宗瑞	父亲
阎天	阎崇年	父亲
金民律	金成柱	父亲
查理·希恩	马丁·希恩	父亲
刘恺威	刘丹	父亲
冯钟芸	冯景兰	父亲
朱允炆	朱标	父亲
托尼·帕克	托尼	父亲
石田三成	石田正继	父亲
乔峰	萧远山	父亲
明神宗	明穆宗	父亲
张素我	张治中	父亲
齐秦	齐济	父亲
谢石	谢玄	父亲
邵华	陈振亚	父亲
刘连昆	刘广智	父亲
保罗-艾伦	Kenneth S Allen	父亲
李由	李斯	父亲
爱新觉罗-永琮	爱新觉罗-弘历	父亲
邓林	邓小平	父亲
张伯驹	张镇芳	父亲
丁宫保	丁建业	父亲
邢羽童	邢光武	父亲
唐德宗	唐代宗李豫	父亲
刘堪	刘统勋	父亲
巩俐	巩力泽	父亲
孙德良	孙国明	父亲
吉文贞	吉坪三	父亲
钱学森 	钱均夫	父亲
张廷玉	张英	父亲
周春秀	周付元	父亲
陈桂亭	陈永年	父亲
绰罗斯-猛可帖木儿	绰罗斯-乌林达	父亲
王紫军	王华强	父亲
张瑶华	张学友	父亲
施春轩	施竹亭	父亲
蒋经国	蒋介石	父亲
罗米娜	莫森-莫哈切克	父亲
古德约翰森	爱诺尔-古德约翰森	父亲
永兴公主	萧衍	父亲
陈布达	陈强	父亲
赵晓梅	赵贵元	父亲
赖俊健	赖昌星	父亲
钱挚	钱伟长	父亲
张一山	张晓武	父亲
孛儿只斤·爱猷识理答腊	孛儿只斤·妥懽帖睦尔	父亲
李伯祥	李洁尘	父亲
袁祥仁	袁小田	父亲
唐哀帝	唐昭宗	父亲
沈伟济	沈秋槎	父亲
本笃十六世	老若瑟-拉辛格	父亲
吴凤保	吴国珍	父亲
哈雅公主	侯赛因·伊本·塔拉勒	父亲
刘恭	刘萌	父亲
威廉·佩利	萨姆·佩利	父亲
殷离	殷野王	父亲
王香桂	王福义	父亲
杜桑·佩特科维奇	伊利亚·佩特科维奇	父亲
胡肇汉	胡传魁	父亲
王恩华	王鸿禄	父亲
徐霞客	徐有勉	父亲
托尼-布莱尔	利奥-布莱尔	父亲
任新民	任海清	父亲
黄一一	黄秋生	父亲
明思宗	明光宗	父亲
萨马兰奇-萨利萨奇斯	萨马兰奇	父亲
成之凡	成舍我	父亲
罗桑确吉坚赞	古公才旦	父亲
晋武帝贵嫔	胡奋	父亲
马吕斯	彭眉胥	父亲
兴平公主	辽圣宗	父亲
周辅臣	周浩然	父亲
六道轮回	六道鲭人	父亲
卢驭龙	卢学东	父亲
刘赐	刘长	父亲
佩顿-曼宁	阿曲-曼宁	父亲
刘允斌	刘少奇	父亲
朱珵墉	朱恬燆	父亲
莫翰德	钱德拉	父亲
拉克萨斯·朵勒阿	伊万·朵勒阿	父亲
张楚儿	张晋	父亲
陈澄	陈德林	父亲
李林妲	马悠	父亲
克里斯汀-斯图尔特	约翰-斯图尔特	父亲
方令孺	方守敦	父亲
林文询	林如稷	父亲
戴尼洪	洪珉圭	父亲
汉灵帝刘宏第一任皇后——宋氏孝灵皇后	宋酆	父亲
陈独秀	陈衍中	父亲
周铭孙	周世南	父亲
刘弗陵	汉武帝	父亲
陈颖	陈存贵	父亲
和硕淑慎公主	爱新觉罗-胤禛	父亲
张俊宏	张庆沛	父亲
丹·艾克洛德	Peter	父亲
黄佳燕	黄涛	父亲
魏振山	魏庆坡	父亲
沈军	沈友根	父亲
品正三	世殿成	父亲
诸葛婉	诸葛冲	父亲
沈珍珠	沈易直	父亲
朱觐钧	朱奠培	父亲
曹操	曹丕	父亲
胡海泉	胡世宗	父亲
万灿	万廷献	父亲
吴敏茜	吴伟文	父亲
宋耀如	韩鸿翼	父亲
蒋纬国	蒋中正	父亲
司马恂	司马防	父亲
迪伦.劳伦	拉尔夫·劳伦	父亲
亚曼达-拜恩斯	瑞克	父亲
周英华	周信芳	父亲
宋共公	宋文公	父亲
刘广文	刘文亨	父亲
拓跋焘	拓跋嗣	父亲
王宏图	王运熙	父亲
鲍桂山	鲍永泰	父亲
王个簃	王少阶	父亲
谢奕幼子和谢尚养子	谢奕	父亲
谭大卫	谭时霖	父亲
龚益德	李学儒	父亲
李奉三	李维汉	父亲
高玉庆	高英培	父亲
沙马-顺达卫	沙勉-顺达叻威	父亲
李信	李春茂	父亲
徐文惠	徐海东	父亲
毛庆祥	毛绍遂	父亲
张茅	张铁夫	父亲
于世文	于连泉	父亲
唐纳德-特朗普	弗雷德-特朗普	父亲
汪应果	汪克东	父亲
谢东	侯宝林	父亲
戴衢亨	戴第元	父亲
依莉雅	卫宫切嗣	父亲
萨科齐	帕尔-萨科齐	父亲
白洁	白玉祥	父亲
董时进	董世绪	父亲
刘瑾	刘沆	父亲
西崎崇子	铃木进一	父亲
查理二世	查理一世	父亲
周筱芳	周庭福	父亲
易翔	易顶峰	父亲
叶亚来	叶联开	父亲
万贵妃	万贵	父亲
凌志军	凌建华	父亲
罗福葆	罗振玉	父亲
王安维	王隆夫	父亲
鲍信	鲍丹	父亲
和有禄	和士英	父亲
真田昌幸	真田幸隆	父亲
阎锡山	阎书堂	父亲
邓琳琳	邓杰古	父亲
曹宪	曹操	父亲
张宁	张富华	父亲
德鲁-古登	安德烈-古登	父亲
威廉-塔夫脱	阿方索-塔夫脱	父亲
哈珀·塞文·贝克汉姆	大卫·贝克汉姆	父亲
远山金一	远山金叉	父亲
洁美-李-寇蒂斯	托尼-柯蒂斯	父亲
石抹也先	脱罗华察儿	父亲
燕厘侯	燕惠侯	父亲
古斯塔夫二世-阿道夫	卡尔九世	父亲
李小林	李先念	父亲
邓颖超	邓延中	父亲
费胜潮	费蒲生	父亲
恒瑞	萨喇善	父亲
阿尔斯兰	阿的江	父亲
赵蘅	赵瑞蕻	父亲
盛佩玉	盛昌颐	父亲
明成祖	明太祖	父亲
陈笃生	陈月中	父亲
宋美龄	宋嘉树	父亲
赵熊诏	赵申吉	父亲
尼采	卡尔-路德维希	父亲
苏洵	苏序	父亲
萧纲	萧衍	父亲
奥莉薇-黛-哈佛兰	沃特-德哈维兰	父亲
李从珂	李嗣源	父亲
郑中基	郑东汉	父亲
慕容盛	慕容宝	父亲
马汀-劳伦斯	约翰-劳伦斯	父亲
林月如	林天南	父亲
王丽卿	王家荫	父亲
张炘炀	张会祥	父亲
阿曼德-哈默	朱利叶斯	父亲
麦考利·库尔金	克里斯多弗·卡尔金	父亲
秦秀	秦朗	父亲
汝南公主	唐太宗李世民	父亲
肖新槐	萧庚更	父亲
王胜志	王青云	父亲
皮帕·米德尔顿	迈克尔·米德尔顿	父亲
计亮年	计竹卿	父亲
谢中杰	谢汉常	父亲
马蒂坎	约瑟夫	父亲
孔垂长	孔维益	父亲
贾蓉	贾珍	父亲
文爱马	文章	父亲
珍妮·巴斯	杰里·巴斯	父亲
刘隆	汉和帝	父亲
阿图罗·比达尔	埃拉斯莫	父亲
李少春	李桂春	父亲
潘鼎新	潘璞	父亲
马金凤	崔合利	父亲
陈敏薰	陈重义	父亲
吴佳多	吴小明	父亲
何雯娜	何龙	父亲
陈鳌	陈文	父亲
王蒙	王锦	父亲
阿尔伯特二世	雷尼尔三世	父亲
古斯塔夫-路德维希-赫兹	古斯塔夫-赫兹	父亲
莉萨·玛丽·普雷斯利	埃尔维斯·普雷斯利	父亲
谢靖	谢国柱	父亲
许光	许世友	父亲
张学良	张闾瑛	父亲
曹寿椿	曹颂彬	父亲
托马斯-罗西基	基里	父亲
佛住	石三泰	父亲
李存源	李荣奎	父亲
吕蓁立	吕清溪	父亲
赵正锡	殷奎太	父亲
陈新	陈建林	父亲
张德武	张玉林	父亲
钱宝森	钱金福	父亲
南铁生	南元超	父亲
邵逸夫	邵玉轩	父亲
朱盘烨	宁献王	父亲
王泽浚	王缵绪	父亲
章士钊	章锦	父亲
武安公主	汉宣帝	父亲
朱友埙	朱悦燫	父亲
贝娜齐尔-布托	佐勒菲卡尔-阿里-布托	父亲
汪桂芬	汪连宝	父亲
凯文-斯贝西	汤玛斯	父亲
惠龄	纳延泰	父亲
刘齐贤	刘祥道	父亲
白玉堂	毕善福	父亲
北条氏康	北条氏纲	父亲
陈瑜	陈照奎	父亲
李密	李宽	父亲
刘锦藻	刘镛	父亲
杨丽华	杨坚	父亲
韩宗武	韩缜	父亲
古拉	库尔德王	父亲
萨曼塔·克鲁格	罗伯特·约翰森	父亲
曹禅	曹永正	父亲
欧阳雯鑫	欧阳奋强	父亲
熊钰翔	熊健	父亲
杨振宁	杨武之	父亲
妮基·希尔顿	瑞克·希尔顿	父亲
科比·布莱恩特	乔·布莱恩特	父亲
伊丽莎白一世	亨利八世	父亲
黄志源	黄奕聪	父亲
路易十九	查理十世	父亲
陈一坚	陈昭奇	父亲
史书翰	史佐卿	父亲
赵彦昭	赵武孟	父亲
小劳勃-道尼	老罗伯特-唐尼	父亲
蒋英	蒋百里	父亲
朴正熙	朴成彬	父亲
于凤至	于文斗	父亲
二条天皇	后白河天皇	父亲
徐鹤宁	徐云龙	父亲
和硕端静公主	康熙帝	父亲
黄珊汕	黄林钦	父亲
仓持明日香	仓持明	父亲
陈珊珊	陈毅	父亲
孔令杰	孔祥熙	父亲
明德马皇后	后汉伏波将军马援	父亲
周恩寿	周劭纲	父亲
约翰·霍华德	莱尔·霍华德	父亲
萧十三	铎鲁斡	父亲
刘禹锡	刘绪	父亲
瑞秋-麦克亚当斯	Lance McAdams	父亲
黄长烨	黄炳德	父亲
于学忠	于荣强	父亲
富宁安	阿兰泰	父亲
时青山	时玉奎	父亲
钱德里卡-班达拉奈克-库马拉通加	所罗门-班达拉奈克	父亲
岛左近	岛信胜	父亲
周叔弢	周学海	父亲
杨庆甲	杨玉厚	父亲
程云	程斌	父亲
孙立人	孙熙泽	父亲
西恩·列侬	约翰·列侬	父亲
林益世	林仙保	父亲
冯沅君	冯台异	父亲
侯伟	侯新生	父亲
安娜·查普曼	瓦西里	父亲
谭凤元	谭宝良	父亲
罗兰·巴特	路易·巴特	父亲
富兰克林-皮尔斯	本杰明-皮尔斯将军	父亲
刘鲁民	刘文瑞	父亲
基伦·威廉姆森	凯思·威廉姆森	父亲
张一伟	张文心	父亲
仲满	仲明	父亲
逝敖	荀息	父亲
郑咏恩	郑少秋	父亲
王语嫣	段正淳	父亲
谢承瑞	谢晓石	父亲
本田吾郎	本田茂治	父亲
赵维仁	赵忠尧	父亲
杰拉德·巴特勒	爱德华·巴特勒	父亲
霍英东	霍耀容	父亲
阿奴	白苗前族长	父亲
汉武帝	汉景帝	父亲
王光超	王治昌	父亲
昆廷-罗斯福	西奥多-罗斯福	父亲
拉尔夫-约翰逊-本奇	弗雷德-本奇	父亲
沈长春	沈玉才	父亲
保罗-福塞尔	老保罗-福塞尔	父亲
李业兴	李玄纪	父亲
贾继英	贾文明	父亲
周绮	周作鹏	父亲
韩襄王	宣惠王	父亲
陈凯歌	陈怀皑	父亲
邵震	邵泽瀛	父亲
厉慧良	厉彦芝	父亲
李学一	李鹏举	父亲
褚蒜子	褚裒	父亲
李玮钟	李范晋	父亲
饶钦止	饶昌朝	父亲
金默玉	第十世肃亲王爱新觉罗-善耆	父亲
萧美娘	萧岿	父亲
伊莫根-托马斯	查尔斯-托马斯	父亲
朱彦淍	朱膺录	父亲
崔本厚	崔焕之	父亲
史进	史太公	父亲
汉殇帝	刘肇	父亲
阿马雷-斯塔德迈尔	阿蒂斯-威尔逊	父亲
六小龄童	章宗义	父亲
乔治-西蒙-欧姆	乔安-渥夫甘-欧姆	父亲
张其锽	张琮	父亲
晋明帝	晋元帝	父亲
唐宣宗长女	唐宣宗李忱	父亲
詹宁斯	查尔斯	父亲
陈远航	陈永武	父亲
张安达	张海宏	父亲
文森特·凡·高	泰奥多勒斯·凡·高	父亲
晏几道	晏殊	父亲
邓绥	邓训	父亲
蔡惠泉	蔡竹卿	父亲
燕穆侯	燕郑侯	父亲
许欢	徐庆春	父亲
达赖一世	滚波多杰	父亲
史蒂芬·库里	戴尔·库里	父亲
莫文骅	莫廷俊	父亲
段勤	段末波	父亲
李露瑾	李鸿年	父亲
孙登	孙权	父亲
唐文宗	唐穆宗	父亲
邓演达	邓镜人	父亲
高华柱	高芳先	父亲
孙翎茜	孙志浩	父亲
楚熊渠	楚熊杨	父亲
陈冰	陈大庆	父亲
鲁道夫-朱利安尼	哈勒德-安卓-朱利安尼	父亲
赵煦	赵顼	父亲
王祐	王彻	父亲
宋应星	宋国霖	父亲
植村直己	植村藤治郎	父亲
霍启人	霍震霆	父亲
陈娟	陈正雷	父亲
徐悱	徐勉	父亲
苏我虾夷	苏我马子	父亲
邓婕	邓渠如	父亲
刘伟民	刘放吾	父亲
陈封怀	陈衡恪	父亲
曹操	曹嵩	父亲
陈建荣	陈永栽	父亲
菲利普国王	阿尔贝二世	父亲
妮基-希尔顿	瑞克-希尔顿	父亲
陈丽颖	陈双喜	父亲
蔡依珊	蔡绿峰	父亲
邓颖超	邓廷忠	父亲
爱新觉罗-弘晖	雍正帝	父亲
小奥利弗·温德尔·霍姆斯	老奥利弗·温德尔·霍姆斯	父亲
德拉科-马尔福	卢修斯-马尔福	父亲
菲德尔·卡斯特罗	安赫尔·卡斯特罗	父亲
周国知	周东海	父亲
席世举	席启悌	父亲
司马懿	司马防	父亲
伊瓜因	豪尔赫·伊瓜因	父亲
刘备	刘弘	父亲
尤利塞斯·辛普森·格兰特	杰西·鲁特·格兰特	父亲
王幼卿	王凤卿	父亲
献贞王后皇甫氏	高丽戴宗	父亲
大名公主	明太祖朱元璋	父亲
宋平公	宋共公	父亲
丁一平	丁秋生	父亲
吴英华	吴鉴泉	父亲
孙存周	孙禄堂	父亲
泷川一益	一胜为泷	父亲
林可胜	林文庆	父亲
西单女孩	任永生	父亲
李晓晓	李光武	父亲
施温提-柏保	蘇恩-伯格斯特龙	父亲
张思乐	张光北	父亲
德仁	明仁天皇	父亲
傅莹	阿民	父亲
福利斯特-马尔斯	老福利斯特	父亲
蒋兆和	蒋茂江	父亲
乔凡尼-巴蒂斯塔-马蒂尼	安东尼奥-玛里亚-马蒂尼	父亲
刘湘	刘文刚	父亲
霍晶	霍武生	父亲
马克西玛-索雷吉耶塔	若热-索雷吉耶塔	父亲
王杰	王侠	父亲
蒋汝藻	蒋书箴	父亲
陈梦松	陈秋雷	父亲
小弗拉迪米尔-魏斯	弗拉迪米尔-魏斯	父亲
谭晓风	谭咏麟	父亲
孙建云	孙禄堂	父亲
莎拉-菲利普斯	Mark Phillips	父亲
曹聚仁	曹梦歧	父亲
梁思永	梁启超	父亲
刘松林	刘谦初	父亲
崔之兰	崔恩岳	父亲
唐瑛	唐乃安	父亲
毛渝南	毛人凤	父亲
毛穆之	毛宝	父亲
完颜宗峻	完颜阿骨打	父亲
赵桓	赵佶	父亲
额尔德特-文绣	额尔德特-端恭	父亲
胡应湘	胡忠	父亲
程继仙	程章圃	父亲
克林特-伊斯特伍德	老克林特-伊斯特伍德	父亲
宋皇后	宋酆	父亲
孔融	孔宙	父亲
谢光选	谢哲孙	父亲
小乔治-史密斯-巴顿	乔治-史密斯-巴顿	父亲
金正恩	金正日	父亲
詹姆斯·奥古斯汀·艾洛依休斯·乔伊斯	约翰·乔伊斯	父亲
魏道武帝	献明帝拓跋寔	父亲
蒋丽萍	蒋震	父亲
袁克文	袁世凯	父亲
王毓宝	王振清	父亲
而金正恩	金正日	父亲
娥皇女英	帝尧	父亲
萧新槐	萧庚更	父亲
钱学森              	钱均夫	父亲
司空星儿	司空摘星	父亲
蒋纬国	蒋介石	父亲
杨德豫	杨叔达	父亲
林明珠	林百欣	父亲
王少姬	王固	父亲
赫拉	克洛诺斯	父亲
女英	帝尧	父亲
陆启铿	陆子骥	父亲
杰奎林·玛氏	老弗雷斯特	父亲
单涛	单玉臣	父亲
布莱恩特	袁世杰	父亲
陈三立	陈宝箴	父亲
莉莉-艾伦	基思-艾伦	父亲
贞懿皇后	独孤颖	父亲
万方	曹禺	父亲
毛利元就	毛利弘元	父亲
陈楠	陈进平	父亲
小池百合子	小池勇二郎	父亲
张大中	张以成	父亲
恩里克·莱塔	乔治·莱塔	父亲
弗拉迪米尔-魏斯	老弗拉迪米尔-魏斯	父亲
安德鲁-怀斯	N-C-怀斯	父亲
廖镇汉	廖伟志	父亲
克里斯多夫-杜德	汤玛斯-约瑟夫-杜德	父亲
曹叡	曹丕	父亲
郭平英	郭沫若	父亲
刘喜益	刘德海	父亲
英如镝	英达	父亲
施松卿	施成灿	父亲
蒋英	蒋百里	父亲
苻坚	苻雄	父亲
梁女莹	梁商	父亲
郭博	郭沫若	父亲
谭晶	谭新民	父亲
丰田章一郎	丰田喜一郎	父亲
赵又廷	赵树海	父亲
王珣	王洽	父亲
宣懿皇后	萧惠	父亲
徐匡华	徐元白	父亲
李呈瑞	李兰馨	父亲
姜东元	姜哲宇	父亲
董诰	董邦达	父亲
于楚楚	于岳	父亲
王濛	王春江	父亲
李戡	李敖	父亲
吉安娜·普罗德摩尔	迪林·普罗德摩尔	父亲
游潜	游弼	父亲
王志勇	王新顺	父亲
章宗义	章益生	父亲
葛洪	葛悌	父亲
柯昌泗	柯劭忞	父亲
刘阿本	刘声道	父亲
王明华	王顺福	父亲
萧润增	萧盛萱	父亲
蔡加赞	蔡志明	父亲
吕美荪	吕凤歧	父亲
朱徽煣	朱楩	父亲
黄旭	黄锦年	父亲
李特	徐浴	父亲
庄宪皇后	王子颜	父亲
李小林	李先念	父亲
埃文-蕾切尔-伍德	Ira David Wood III	父亲
艾伦-耶格尔	格里沙-耶格尔	父亲
赵一涵	赵本山	父亲
吴忠良	吴自再	父亲
玛格利特-撒切尔	亚佛列??罗伯茨	父亲
尚继春	尚长春	父亲
陶汉章	陶南山	父亲
胡文新	胡应湘	父亲
隆虑公主	汉明帝	父亲
应神天皇	仲哀天皇	父亲
朱启南	朱远有	父亲
赵义	赵国强	父亲
拓跋绍	拓跋圭	父亲
达-芬奇	皮耶罗	父亲
管笑笑	莫言	父亲
朱金琴	朱桂芳	父亲
谭娜	谭长友	父亲
徐尚宾	徐志良	父亲
沈月泉	沈寿林	父亲
何宴	何进	父亲
朱徽焟	朱楩	父亲
洪煦榆	洪金宝	父亲
陈宇华	陈文福	父亲
陈世骧	陈坚	父亲
张德武	张玉林	父亲
赫连定	赫连勃勃	父亲
魏建军	魏德义	父亲
窦德妃	窦孝谌	父亲
黄兴	黄筱村	父亲
萧友梅	萧煜增	父亲
苗彤	苗侨伟	父亲
孙策	孙坚	父亲
廖烈文	廖宝珊	父亲
达玛	赤德松赞	父亲
王润身	王魁武	父亲
李思	李连杰	父亲
戴兰·布隆多	帕塔里克·布隆多	父亲
庄思华	庄宝	父亲
韩仲晰	韩医仙	父亲
吴小军	吴亚平	父亲
赵惠文王	赵武灵王	父亲
夏姬	郑穆公	父亲
李学国	李连荣	父亲
爱新觉罗-永璘	爱新觉罗-弘历	父亲
药家鑫	药青伟	父亲
莉萨-埃德尔斯坦	Alvin Edelstein	父亲
郑定公	郑简公	父亲
李暠	李昶	父亲
邰丽华	邰祖杰	父亲
黄壮勉	黄固喜	父亲
吴锡龄	吴思英	父亲
辛艾	辛玉祥	父亲
李小璐  	李丹宁	父亲
姜丽文	秦沛	父亲
凌子	叶剑英	父亲
塔米尔-科恩	阿维-科恩	父亲
周建安	周必康	父亲
刘琼	刘本之	父亲
吴少微	吴义方	父亲
安阳公主	曹操	父亲
林海峰	林国圭	父亲
乐史	乐黄	父亲
王威旸	王义夫	父亲
马鹤凌	马立安	父亲
张宁	张富华	父亲
李欣	李宗义	父亲
柳小青	柳致远	父亲
楚穆王	楚成王恽	父亲
武田信廉	武田信虎	父亲
李伦	李克农	父亲
横山光辉	手冢治虫	父亲
斯坦利-鲍德温	艾尔弗雷德-鲍德温	父亲
赵延寿	赵德钧	父亲
杰瑞米-雷纳	Lee	父亲
杨易辰	杨文山	父亲
郑繻公	郑幽公	父亲
齐威王	齐桓公	父亲
陈永燊	陈瑞球博士	父亲
梵高	泰奥多勒斯-梵高	父亲
乔瑟夫·高登-李维	丹尼斯·拉维特	父亲
丁彦雨航	丁峰	父亲
储望华	储安平	父亲
萧楷成	萧伏山	父亲
阿里-邦戈	奥马尔-邦戈-翁丁巴	父亲
长泽雅美	长泽和明	父亲
三浦贵大	三浦友和	父亲
何厚铧	何贤	父亲
李石曾	李鸿藻	父亲
蒋碧微	蒋梅笙	父亲
马佩璋	马维琪	父亲
徐静蕾	徐子健	父亲
金民国	金成柱	父亲
郭台强	郭龄瑞	父亲
赵世曾	赵从衍	父亲
李志奇	李环春	父亲
孙和	孙权	父亲
陆长通	陆德芬	父亲
陈寿峰	陈金雀	父亲
潘允端	潘恩	父亲
耶律齐	耶律楚材	父亲
张静江	张定甫	父亲
林赛·罗韩	迈克尔·罗韩	父亲
诸葛文彪	诸葛恢	父亲
胡盈祯	胡瓜	父亲
朱熹	朱松	父亲
陆无双	陆立鼎	父亲
刘寄	汉景帝	父亲
李云峰	李万堂	父亲
巴蒂亚·米塔尔	米塔尔	父亲
束际清	束世微	父亲
爱新觉罗·文嘉	溥佺	父亲
郭先生	郭孟申	父亲
淳颖	如松	父亲
刘公诚	刘鸿生	父亲
马英九	马鹤凌	父亲
乔韵如	乔玉林	父亲
杨哲安	杨孝华	父亲
蔡加怡	蔡志明	父亲
赖元葵	赖广益	父亲
邓小平	邓绍昌	父亲
郑和	马哈只	父亲
艾南-塞利斯特-考雷	瓦伦丁-考雷	父亲
神功皇后	气长宿祢王	父亲
范纯仁	范仲淹	父亲
张宗燧	张东荪	父亲
祁星雨	祁楚财	父亲
庚丁	祖甲	父亲
周秀英	周立春	父亲
彭良臣	彭化鹏	父亲
爱新觉罗·玄烨	爱新觉罗·福临	父亲
程虹	程金瑞	父亲
李济深	李沛文	父亲
哈里-胡迪尼	梅尔-山谬-怀兹	父亲
田青文	田归农	父亲
王谠	王彭	父亲
苏瑞	汤姆·克鲁斯	父亲
刘永美	刘大镛	父亲
小托马斯-沃森	老托马斯-沃森	父亲
赵均	赵宧光	父亲
杰拉德-皮克-伯纳乌	约翰	父亲
蒋孝文	蒋经国	父亲
江辰鸿	江吉雄	父亲
哈维纳尔	迪多-哈维纳尔	父亲
侯赛因	巴拉克-侯赛因-奥巴马一世	父亲
李安琪	李小平	父亲
崔成熙	崔世月	父亲
倪桂珍	倪蕴山	父亲
贾登-史密斯	Will	父亲
郑小提	郑律成	父亲
许光	许世友	父亲
秦晓	秦力生	父亲
赫连昌	赫连勃勃	父亲
唐代宗皇后	独孤颖	父亲
埃胡德·奥尔默特	莫德卡·奥尔默特	父亲
杜致礼	杜聿明	父亲
赵括	赵奢	父亲
李瑁	李隆基	父亲
罗兰-巴特	路易-巴特	父亲
郭奕	郭嘉	父亲
和政公主	唐肃宗李亨	父亲
红孩儿	牛魔王	父亲
喀恺	瓜喇	父亲
西汉吴氏长沙国第三代王和吴臣长子	吴臣	父亲
刁爱青	刁日昌	父亲
李日曦	李允枫	父亲
贺兰敏月	贺兰越石	父亲
汪振凯	汪东兴	父亲
陈熙	陈彼得	父亲
郭璞	郭瑗	父亲
斐迪南·福煦	破仑·福煦	父亲
周与良	周叔弢	父亲
凌洁	凌春玖	父亲
马珏	马裕藻	父亲
冯巩	冯海岗	父亲
黎海宁	黎草田	父亲
李堡	李咏	父亲
胡为真	胡宗南	父亲
刘星	胡一统	父亲
王梓涵	王斑	父亲
姚承光	姚宗勋	父亲
陈晓旭	陈强	父亲
张厉生	张绳武	父亲
辽景宗	辽世宗	父亲
麦浚龙	麦绍棠	父亲
李安妮	李登辉	父亲
吉田茂	竹内纲	父亲
唐石霞	唐志锜	父亲
徐熙媛	徐坚	父亲
陈义	陈亦发	父亲
刘田一	刘觉民	父亲
金乡公主	曹操	父亲
杨仙逸	杨著昆	父亲
同治	咸丰	父亲
夫差	阖闾	父亲
爱新觉罗-旻宁	爱新觉罗-颙琰	父亲
陈由伟	陈景润	父亲
姜吻吻	姜植喜	父亲
庄静固伦公主	嘉庆	父亲
赵佩茹	赵希贤	父亲
周宝财	周冬林	父亲
切·格瓦拉	埃内斯托·格瓦拉·林奇	父亲
循贵妃	桂林	父亲
蔡智明	蔡元发	父亲
刘隆	刘肇	父亲
李永豪	李家鼎	父亲
李小璐 	李丹宁	父亲
爱新觉罗-永琪	爱新觉罗-弘历	父亲
张子平	张伯孚	父亲
刘忆如	刘庆瑞	父亲
韩武子	曲沃桓叔	父亲
陆小曼	陆定	父亲
许冠文	许世昌	父亲
阿炳	华清和	父亲
江万里	江烨	父亲
长城公主	梁武帝	父亲
黄芃芃	黄仕明	父亲
黄维垣	黄益三	父亲
张小春	张廷发	父亲
葛彤	葛绥之	父亲
刘宗杨	刘砚芳	父亲
戴兰-布隆多	帕塔里克-布隆多	父亲
李泳豪	李家鼎	父亲
巴伦·特朗普	唐纳德·特朗普	父亲
贾三近	贾梦龙	父亲
克里斯汀·斯图尔特	约翰·斯图尔特	父亲
姚雯敏	姚浩南	父亲
迈克尔-富特	艾萨克-富特	父亲
埃丝特·克利夫兰·博赞科特	格罗弗·克利夫兰	父亲
伊兰迪尔	阿门迪尔	父亲
丹朱	尧帝	父亲
陆小芬	陆玉凤	父亲
纳塔利亚-戴蒙特-布莱恩特	科比-布莱恩特	父亲
孙汉治	孙振文	父亲
塔察儿	只不干	父亲
王士英	王又宸	父亲
艾蜜莉-莫特	约翰-莫迪默	父亲
克里斯-保罗	查尔斯-保罗	父亲
赵括	马服君赵奢	父亲
圣洁-凡蕾丝	Rachel Valance	父亲
梁晓天	梁天	父亲
郭令明	郭芳枫	父亲
万伯翱	万里	父亲
范妮莎-L-威廉姆斯	Milton Williams	父亲
徐森荣	徐金声	父亲
赵薇	赵家海	父亲
玛丽-布莱特	托马斯-布莱特	父亲
陈娟	陈正雷	父亲
朱宠涭	朱恩鑙	父亲
钱多多	钱继元	父亲
吉本多香美	黑部进	父亲
爱新觉罗-福宜	爱新觉罗-胤禛	父亲
俊杰	张旺	父亲
郭荣起	郭瑞林	父亲
妥罗	充善	父亲
宋真宗	宋太宗	父亲
张天爱	张有兴	父亲
路飞	蒙奇-D-龙	父亲
杀生丸	斗牙王	父亲
刘月生	刘连启	父亲
秦本军	蒋志刚	父亲
江小鱼	江枫	父亲
诸葛尚	诸葛瞻	父亲
野原广志	野原银之介	父亲
沈奇	沈大伟	父亲
马西莫	安杰洛	父亲
者勒蔑	札儿赤兀歹	父亲
阿卜杜拉	伊本·沙特	父亲
夏绍范	夏时济	父亲
安定公主	唐高宗李治	父亲
叶选宁	叶剑英	父亲
神原康政	神原长政	父亲
刘娇	刘志平	父亲
何超盈	何鸿燊	父亲
杨为民	杨秀峰	父亲
冯锡范	冯澄世	父亲
吴敬梓	吴霖起	父亲
皮埃尔-居里	尤金-居里	父亲
宋宁宗	宋光宗	父亲
琳恩·切尼	韦恩·埃德溫·文生	父亲
李瑁	唐玄宗	父亲
李百药	李德林	父亲
邢萍	邢永华	父亲
林素朴	林信斋	父亲
俞珊	俞大纯	父亲
李香凝	李小龙	父亲
蔡攸	蔡京	父亲
谢晖	谢若水	父亲
尤里西斯·辛普森·格兰特	杰西·鲁特·格兰特	父亲
珊农·露茜德	奥斯卡	父亲
荣寿公主	爱新觉罗-奕訢	父亲
徐硕	徐焕文	父亲
李曼青	李寻欢	父亲
皮特·桑普拉斯	山姆.桑普拉斯	父亲
西汉中山靖王	汉景帝刘启	父亲
张楚儿	张晋	父亲
唐应恩	唐时昌	父亲
邵家业	邵度	父亲
朱天文	朱西宁	父亲
郑昭公	郑庄公	父亲
陈汶俤	陈显灿	父亲
辛宪英	辛毗	父亲
张致祥	管葆元	父亲
杰西卡·阿尔芭	马克·阿尔巴	父亲
查克-马威尼	查尔斯-B-马威尼	父亲
爱新觉罗-皇太极	爱新觉罗-努尔哈赤	父亲
王缉思	王力	父亲
濮方	濮存昕	父亲
司马保	司马模	父亲
白家麟	白瑞清	父亲
郭心心	郭英俊	父亲
廖雅丽	廖树林	父亲
杨起	杨振声	父亲
立花訚千代	立花道雪	父亲
玛格利特·撒切尔	亚佛列罗伯茨	父亲
塔玛拉-艾可莱斯顿	伯尼-艾可莱斯顿	父亲
佩姬·约翰森	罗伯特·约翰森	父亲
霍金斯	威廉-霍金斯	父亲
薛刚	薛丁山	父亲
陈德慧	陈五芝	父亲
袁克坚	袁世凯	父亲
马茨-胡梅尔斯	赫尔曼-胡梅尔斯	父亲
中森青子	中森银三	父亲
韦恩-鲁尼	汤马士-韦恩-鲁尼	父亲
李芸	李志舆	父亲
奥格·尼尔斯·玻尔	尼尔斯·玻尔	父亲
张浩锋	莫少聪	父亲
朱青阳	朱时茂	父亲
刘方	刘振江	父亲
丽兹·切尼	迪克·切尼	父亲
曹秀清	曹万滋	父亲
裴楷	裴徽	父亲
王昭君	王穰	父亲
敬武公主	汉宣帝	父亲
哈里王子	查尔斯	父亲
奥逊-威尔斯	理查德??海德	父亲
雷振春	雷喜福	父亲
徐道邻	徐树铮	父亲
唐高宗之女：安定思公主	唐高宗李治	父亲
傅吾康	奥托-福兰阁	父亲
吕志和	吕金铨	父亲
邹鸿成	邹孙楷	父亲
赵合德	班况	父亲
